NO KNOWN DIETARY SUPPLEMENTS A | NO KNOWN DIETARY SUPPLEMENTS A
NO KNOWN OTC or PRESCRIBED MED | NO KNOWN OTC or PRESCRIBED MED
Centrum | Centrum
Acetaminophen | Acetaminophen
Vitamin D3 | Vitamin D3
Permethrin | Permethrin
Tylenol Childrens | Tylenol Childrens
Bacitracin | Bacitracin
Keflex | Keflex
Oseltamivir Phosphate | Oseltamivir Phosphate
Tamiflu | Tamiflu
Flintstones Complete | Flintstones Complete
Tylenol | Tylenol
Caltrate 600+D | Caltrate 600+D
Calcium | Calcium
Multivitamins | Multivitamins
Zithromax | Zithromax
Azithromycin | Azithromycin
Dimetapp DM Cold/Cough | Dimetapp DM Cold/Cough
Benzamycin | Benzamycin
Tinactin | Tinactin
AeroChamber Plus | AeroChamber Plus
Albuterol Sulfate HFA | Albuterol Sulfate HFA
NO KNOWN OTC MEDS | NO KNOWN OTC MEDS
Naproxen Sodium | Naproxen Sodium
Valacyclovir HCl | Valacyclovir HCl
aerochamber | aerochamber
Albuterol Sulfate | Albuterol Sulfate
Hydrocortisone | Hydrocortisone
Singulair | Singulair
Flonase | Flonase
Montelukast Sodium | Montelukast Sodium
Claritin | Claritin
Ibuprofen | Ibuprofen
Dimetapp Cold/Allergy | Dimetapp Cold/Allergy
PredniSONE | PredniSONE
Clean &amp; Clear Advantage Acne | Clean &amp; Clear Advantage Acne
PrednisoLONE | PrednisoLONE
Pulmicort | Pulmicort
Triamcinolone Acetonide | Triamcinolone Acetonide
Cetaphil | Cetaphil
Cetaphil Daily Facial Moist | Cetaphil Daily Facial Moist
Visine-A | Visine-A
Benzoyl Peroxide-Erythromycin | Benzoyl Peroxide-Erythromycin
Amoxicillin | Amoxicillin
Ibuprofen Childrens | Ibuprofen Childrens
Symbicort | Symbicort
Unable to recall. Advised to | Unable to recall. Advised to
Analgesic GRX Balm | Analgesic GRX Balm
Milk of Magnesia | Milk of Magnesia
Cold Tablets | Cold Tablets
Guaifenesin | Guaifenesin
Motrin | Motrin
Sudafed | Sudafed
IBU-200 | IBU-200
Benadryl Allergy Childrens | Benadryl Allergy Childrens
Loratadine | Loratadine
MiraLax | MiraLax
DiphenhydrAMINE HCl | DiphenhydrAMINE HCl
Custom Molded Foot Orthotics | Custom Molded Foot Orthotics
Polytrim | Polytrim
Zaditor | Zaditor
Debrox | Debrox
Adderall | Adderall
Ulesfia | Ulesfia
Permethrin Lice Treatment | Permethrin Lice Treatment
Benzoyl Peroxide Wash | Benzoyl Peroxide Wash
Clindamycin Phosphate | Clindamycin Phosphate
Sodium Sulfacetamide Wash | Sodium Sulfacetamide Wash
Tretinoin | Tretinoin
Naproxen | Naproxen
Aygestin | Aygestin
Benzoyl Peroxide | Benzoyl Peroxide
Cleocin-T | Cleocin-T
Retin-A | Retin-A
Ferrous Sulfate | Ferrous Sulfate
Bacitracin Zinc | Bacitracin Zinc
Gummi Bear Multivitamin/Min | Gummi Bear Multivitamin/Min
Cholecalciferol | Cholecalciferol
Cromolyn Sodium | Cromolyn Sodium
Mucinex | Mucinex
Pedialyte | Pedialyte
Ful-Glo | Ful-Glo
Glasses | Glasses
Brotapp DM | Brotapp DM
Erythromycin | Erythromycin
Albuterol | Albuterol
Ceftin | Ceftin
Tobramycin-Dexamethasone | Tobramycin-Dexamethasone
Minocycline HCl | Minocycline HCl
Motrin Junior Strength | Motrin Junior Strength
Ranitidine HCl | Ranitidine HCl
Vitamin D-3 | Vitamin D-3
Fluoxetine | Fluoxetine
Melatonin | Melatonin
Saline Mist | Saline Mist
Cepacol Sore Throat | Cepacol Sore Throat
Multivitamin | Multivitamin
Pseudoephedrine HCl | Pseudoephedrine HCl
Penicillin V Potassium | Penicillin V Potassium
Vitamin D High Potency | Vitamin D High Potency
Lice Killing Maximum Strength | Lice Killing Maximum Strength
Lice Treatment | Lice Treatment
Multivital-M | Multivital-M
Nadolol | Nadolol
Zoloft | Zoloft
Bactroban | Bactroban
Desmopressin Acetate | Desmopressin Acetate
Senna | Senna
Westcort | Westcort
Ergocalciferol | Ergocalciferol
Motrin IB | Motrin IB
Benzonatate | Benzonatate
Robitussin DM | Robitussin DM
Saline Nasal Spray | Saline Nasal Spray
One-A-Day Teen Advantage/Him | One-A-Day Teen Advantage/Him
Simethicone | Simethicone
Flovent HFA | Flovent HFA
Childrens Motrin | Childrens Motrin
Nebulizer Compressor | Nebulizer Compressor
Vitamin D | Vitamin D
Next Choice One Dose | Next Choice One Dose
Levonorgestrel | Levonorgestrel
Vitamin D (Ergocalciferol) | Vitamin D (Ergocalciferol)
Benefiber | Benefiber
Zithromax Z-Pak | Zithromax Z-Pak
Cyclogyl | Cyclogyl
Phenylephrine HCl | Phenylephrine HCl
Proparacaine HCl | Proparacaine HCl
Tropicamide | Tropicamide
Aclovate | Aclovate
Multivitamin/Iron | Multivitamin/Iron
Zantac | Zantac
Prenatal Low Iron | Prenatal Low Iron
Advil | Advil
motrin | motrin
Tazorac | Tazorac
Colace | Colace
Advair Diskus | Advair Diskus
Ventolin HFA | Ventolin HFA
Flagyl | Flagyl
Isotretinoin | Isotretinoin
Lexapro | Lexapro
Mineral Oil | Mineral Oil
Mirtazapine | Mirtazapine
Nexium | Nexium
Polyethylene Glycol 3350 | Polyethylene Glycol 3350
Nystatin-Triamcinolone | Nystatin-Triamcinolone
Sudafed Childrens | Sudafed Childrens
Brevoxyl-4 Creamy Wash | Brevoxyl-4 Creamy Wash
Hydrocortisone Valerate | Hydrocortisone Valerate
benzamycin gel | benzamycin gel
Fe Tabs | Fe Tabs
Loestrin 24 Fe | Loestrin 24 Fe
Multi Prenatal | Multi Prenatal
Metformin HCl | Metformin HCl
no daily meds | no daily meds
Tri-Sprintec | Tri-Sprintec
Ketoconazole | Ketoconazole
Patanol | Patanol
Feosol | Feosol
Vitamin C | Vitamin C
Maalox | Maalox
Penicillin G Benzathine | Penicillin G Benzathine
Benadryl | Benadryl
Nasacort AQ | Nasacort AQ
Plan B One-Step | Plan B One-Step
BuSpar | BuSpar
Celexa | Celexa
Seroquel | Seroquel
None | None
Depo-Provera | Depo-Provera
Plan B | Plan B
Atenolol | Atenolol
Must complete | Must complete
Omeprazole | Omeprazole
Paxil | Paxil
Depakote ER | Depakote ER
Risperdal | Risperdal
Microgestin 1/20 | Microgestin 1/20
Iron | Iron
Prenatal 1 Plus 1 | Prenatal 1 Plus 1
Proventil HFA | Proventil HFA
BenzamycinPak | BenzamycinPak
Prenatal | Prenatal
OptiChamber Advantage | OptiChamber Advantage
Mirena | Mirena
Pepcid | Pepcid
Isoniazid | Isoniazid
Ciclopirox | Ciclopirox
Nasonex | Nasonex
Augmentin | Augmentin
Ketotifen Fumarate | Ketotifen Fumarate
Ortho Evra | Ortho Evra
EpiPen 2-Pak | EpiPen 2-Pak
HydrOXYzine HCl | HydrOXYzine HCl
Spenco Orthotic Arch Supports | Spenco Orthotic Arch Supports
Calcium + D | Calcium + D
Pantoprazole Sodium | Pantoprazole Sodium
Differin | Differin
Diastat AcuDial | Diastat AcuDial
AeroChamber Plus w/Mask | AeroChamber Plus w/Mask
Polyvitamin/Iron | Polyvitamin/Iron
Pataday | Pataday
Tylenol 8 Hour | Tylenol 8 Hour
NO KNOWN PRESCRIBED MEDS | NO KNOWN PRESCRIBED MEDS
Allegra Allergy | Allegra Allergy
Cephalexin | Cephalexin
NuvaRing | NuvaRing
Adapalene | Adapalene
Ammonium Lactate | Ammonium Lactate
Vitamin B Complex-C | Vitamin B Complex-C
Cyproheptadine HCl | Cyproheptadine HCl
Fish Oil | Fish Oil
Synthroid | Synthroid
Tramadol HCl | Tramadol HCl
Amoxil | Amoxil
Drospirenone-Ethinyl Estradiol | Drospirenone-Ethinyl Estradiol
Vitamin D (Cholecalciferol) | Vitamin D (Cholecalciferol)
Clindamycin Phos-Benzoyl Perox | Clindamycin Phos-Benzoyl Perox
Amlodipine Besylate | Amlodipine Besylate
Lisinopril-Hydrochlorothiazide | Lisinopril-Hydrochlorothiazide
Dulcolax | Dulcolax
Pt does not recall medication | Pt does not recall medication
Mometasone Furoate | Mometasone Furoate
Multi Vitamin/Minerals | Multi Vitamin/Minerals
Visine Advanced Relief | Visine Advanced Relief
Mederma | Mederma
Excedrin Migraine | Excedrin Migraine
Ziprasidone HCl | Ziprasidone HCl
Compressor/Nebulizer | Compressor/Nebulizer
IUD's | IUD's
Lotrisone | Lotrisone
Prenatal Vitamins | Prenatal Vitamins
Tetrahydrozoline-Zn Sulfate | Tetrahydrozoline-Zn Sulfate
MedroxyPROGESTERone Acetate | MedroxyPROGESTERone Acetate
Provera | Provera
Dulera | Dulera
Nebulizer/Adult Mask | Nebulizer/Adult Mask
Azelastine HCl | Azelastine HCl
Purified Water | Purified Water
Gildess 1/20 | Gildess 1/20
Multi-Day Plus Iron | Multi-Day Plus Iron
Ferrous Sulfate-C-FA ER | Ferrous Sulfate-C-FA ER
Breast Pump | Breast Pump
Ortho Tri-Cyclen Lo | Ortho Tri-Cyclen Lo
My Way | My Way
Ortho-Cyclen (28) | Ortho-Cyclen (28)
Adderall XR | Adderall XR
Trazodone HCl | Trazodone HCl
Wellbutrin XL | Wellbutrin XL
Minocin | Minocin
Concerta | Concerta
Kaletra | Kaletra
PediaSure | PediaSure
Sustiva | Sustiva
Viread | Viread
Prenatal Multi +DHA | Prenatal Multi +DHA
Alesse (28) | Alesse (28)
TriNessa (28) | TriNessa (28)
Cepacol Regular Strength | Cepacol Regular Strength
Prozac | Prozac
Penlac | Penlac
Folic Acid | Folic Acid
Prenatal Formula | Prenatal Formula
Benzaclin | Benzaclin
Fluocinonide | Fluocinonide
Zantac 150 Maximum Strength | Zantac 150 Maximum Strength
Clotrimazole | Clotrimazole
Econazole Nitrate | Econazole Nitrate
Pred Forte | Pred Forte
Loprox | Loprox
Metrogel Vaginal | Metrogel Vaginal
Terazol 3 | Terazol 3
Mucinex DM | Mucinex DM
Ciprodex | Ciprodex
Ciprofloxacin-Hydrocortisone | Ciprofloxacin-Hydrocortisone
Cortisporin | Cortisporin
Cipro | Cipro
Loestrin Fe 1/20 | Loestrin Fe 1/20
Desogen | Desogen
Astelin | Astelin
Nebulizer | Nebulizer
Zyrtec Allergy | Zyrtec Allergy
Lotrimin AF | Lotrimin AF
Lutera | Lutera
Betamethasone Dipropionate | Betamethasone Dipropionate
Levofloxacin | Levofloxacin
Metrogel | Metrogel
Medrol (Pak) | Medrol (Pak)
Minastrin 24 Fe | Minastrin 24 Fe
Salicylic Acid | Salicylic Acid
Macrobid | Macrobid
Bromfed DM | Bromfed DM
Hydroquinone | Hydroquinone
Gildess FE 1/20 | Gildess FE 1/20
Vitamin D-1000 Max St | Vitamin D-1000 Max St
Vitamin B-6 | Vitamin B-6
Griseofulvin Microsize | Griseofulvin Microsize
Griseofulvin Ultramicrosize | Griseofulvin Ultramicrosize
Omega 3-6-9 Complex | Omega 3-6-9 Complex
Diflucan | Diflucan
Pediatric Multivitamins-Iron | Pediatric Multivitamins-Iron
Duofilm | Duofilm
Benadryl Itch Relief | Benadryl Itch Relief
Cetirizine HCl | Cetirizine HCl
Iron Supplement | Iron Supplement
Multivital | Multivital
Senna Laxative | Senna Laxative
Doxycycline Hyclate | Doxycycline Hyclate
Ortho Tri-Cyclen (28) | Ortho Tri-Cyclen (28)
DM-Guaifenesin ER | DM-Guaifenesin ER
Metoclopramide HCl | Metoclopramide HCl
Loestrin 1/20 (21) | Loestrin 1/20 (21)
Sudafed 12 Hour | Sudafed 12 Hour
Metamucil Clear &amp; Natural | Metamucil Clear &amp; Natural
Abilify | Abilify
Topamax | Topamax
Geodon | Geodon
Abreva | Abreva
Butalbital-APAP-Caffeine | Butalbital-APAP-Caffeine
Somatropin | Somatropin
Clarithromycin | Clarithromycin
Prevacid | Prevacid
Locoid | Locoid
Keppra | Keppra
Lamictal | Lamictal
Aquaphor | Aquaphor
Fluticasone Propionate | Fluticasone Propionate
Allegra Allergy Childrens | Allegra Allergy Childrens
Vitamins/Minerals | Vitamins/Minerals
Benadryl Allergy | Benadryl Allergy
Proventil | Proventil
Prenatal 1 | Prenatal 1
EpiPen | EpiPen
Tacrolimus | Tacrolimus
Cutivate | Cutivate
Gemfibrozil | Gemfibrozil
Ciclopirox &amp; Lacquer Removal | Ciclopirox &amp; Lacquer Removal
Clobetasol Propionate | Clobetasol Propionate
Lamisil | Lamisil
Acyclovir | Acyclovir
Selsun | Selsun
Temovate | Temovate
Multi-Vitamin/Iron | Multi-Vitamin/Iron
Hydrochlorothiazide | Hydrochlorothiazide
Terbinafine HCl | Terbinafine HCl
Calcium 600+D | Calcium 600+D
Tears Pure | Tears Pure
Cefdinir | Cefdinir
Zofran | Zofran
Misoprostol | Misoprostol
Famotidine | Famotidine
Vitamin D-3 Super Strength | Vitamin D-3 Super Strength
Tetracycline HCl | Tetracycline HCl
Pediotic | Pediotic
Sudafed 24 Hour Non-Drowsy | Sudafed 24 Hour Non-Drowsy
Fexofenadine HCl | Fexofenadine HCl
Sprintec 28 | Sprintec 28
Visine | Visine
Anaprox DS | Anaprox DS
Lac-Hydrin | Lac-Hydrin
ACE Bandage | ACE Bandage
Crutch Accessory Kit | Crutch Accessory Kit
Lidocaine Viscous | Lidocaine Viscous
Acne Wash | Acne Wash
Fluticasone Furoate | Fluticasone Furoate
Chloraseptic Gargle | Chloraseptic Gargle
Amoxicill-Clarithro-Omeprazole | Amoxicill-Clarithro-Omeprazole
Sulfamethoxazole-Trimethoprim | Sulfamethoxazole-Trimethoprim
Reglan | Reglan
Lac-Hydrin Twelve | Lac-Hydrin Twelve
Ayr | Ayr
Cepacol Sore Throat &amp; Cough | Cepacol Sore Throat &amp; Cough
Emoquette | Emoquette
Antacid | Antacid
Erythromycin Base | Erythromycin Base
Maxair Autohaler | Maxair Autohaler
Dextromethorphan HBr | Dextromethorphan HBr
Ciloxan | Ciloxan
EpiPen Jr 2-Pak | EpiPen Jr 2-Pak
Qvar | Qvar
Clindagel | Clindagel
Desonide | Desonide
Loratadine Allergy Relief | Loratadine Allergy Relief
Tenex | Tenex
AeroChamber MAX w/Mask Large | AeroChamber MAX w/Mask Large
Clotrimazole-Betamethasone | Clotrimazole-Betamethasone
Ensure | Ensure
Pepcid AC Maximum Strength | Pepcid AC Maximum Strength
Blood Pressure Monitor | Blood Pressure Monitor
Enalapril Maleate | Enalapril Maleate
Lactulose | Lactulose
Saline | Saline
Excedrin | Excedrin
Topiramate | Topiramate
Robitussin Cough/Cold Long-Act | Robitussin Cough/Cold Long-Act
Levothyroxine Sodium | Levothyroxine Sodium
Alkalol | Alkalol
Megace Oral | Megace Oral
Meclizine HCl | Meclizine HCl
Bismuth Subsalicylate | Bismuth Subsalicylate
Fluconazole | Fluconazole
BD Pen Needle Nano U/F | BD Pen Needle Nano U/F
Byetta 5 MCG Pen | Byetta 5 MCG Pen
Glucometer Elite Classic | Glucometer Elite Classic
Lancets 31 G | Lancets 31 G
Pioglitazone HCl | Pioglitazone HCl
Test Strips | Test Strips
Vitamin E | Vitamin E
Lisinopril | Lisinopril
Prenatal 19 | Prenatal 19
Optivar | Optivar
Claritin-D 12 Hour | Claritin-D 12 Hour
Calcium 1000 + D | Calcium 1000 + D
Dexamethasone | Dexamethasone
Zithromax Tri-Pak | Zithromax Tri-Pak
Valtrex | Valtrex
One-A-Day Teen Advantage/Her | One-A-Day Teen Advantage/Her
OptiChamber Advantage-Lg Mask | OptiChamber Advantage-Lg Mask
Next Choice | Next Choice
Clonazepam | Clonazepam
Robitussin Cold Cough+ Chest | Robitussin Cold Cough+ Chest
Aller-Ease | Aller-Ease
Lo Loestrin Fe | Lo Loestrin Fe
Pyridoxine HCl | Pyridoxine HCl
Pepto-Bismol | Pepto-Bismol
Zofran ODT | Zofran ODT
Bacitracin-Neomycin-Polymyxin | Bacitracin-Neomycin-Polymyxin
Maxitrol | Maxitrol
Promethazine-DM | Promethazine-DM
Symbicot | Symbicot
Cefaclor | Cefaclor
Norgestrel-Ethinyl Estradiol | Norgestrel-Ethinyl Estradiol
Tev-Tropin | Tev-Tropin
Chewable Vite/Iron Childrens | Chewable Vite/Iron Childrens
Iron-Vitamins | Iron-Vitamins
Bactrim DS | Bactrim DS
Gentamicin Sulfate | Gentamicin Sulfate
Metronidazole | Metronidazole
Pseudoephedrine-DM-GG-APAP | Pseudoephedrine-DM-GG-APAP
Miconazole Nitrate-Wipes | Miconazole Nitrate-Wipes
Mucinex D | Mucinex D
Flexeril | Flexeril
Clarinex | Clarinex
Cleocin | Cleocin
DayQuil Multi-Symptom Cold/Flu | DayQuil Multi-Symptom Cold/Flu
Zovirax | Zovirax
Pyridium | Pyridium
Amitriptyline HCl | Amitriptyline HCl
Sulfamethoxazole-TMP DS | Sulfamethoxazole-TMP DS
Clindamycin HCl | Clindamycin HCl
Chloraseptic | Chloraseptic
Levonorgestrel-Ethinyl Estrad | Levonorgestrel-Ethinyl Estrad
micronor | micronor
Nor-QD | Nor-QD
Terazol 7 | Terazol 7
TheraFlu Flu/Cold | TheraFlu Flu/Cold
Urea | Urea
Loestrin Fe 1.5/30 | Loestrin Fe 1.5/30
Microgestin FE 1/20 | Microgestin FE 1/20
Nortrel 1/35 (28) | Nortrel 1/35 (28)
Guaifenesin DM | Guaifenesin DM
Mag-Al Plus | Mag-Al Plus
Allegra | Allegra
Amoxicillin-Pot Clavulanate | Amoxicillin-Pot Clavulanate
Cymbalta | Cymbalta
Neurontin | Neurontin
Mupirocin | Mupirocin
Junel 1/20 | Junel 1/20
Grifulvin V | Grifulvin V
Clotrimazole-7 | Clotrimazole-7
Paragard Intrauterine Copper | Paragard Intrauterine Copper
CeraVe Foaming Facial Cleanser | CeraVe Foaming Facial Cleanser
Cod Liver Oil | Cod Liver Oil
Zyrtec | Zyrtec
Cryselle-28 | Cryselle-28
Ofloxacin | Ofloxacin
CVS Children Multivitamin/Iron | CVS Children Multivitamin/Iron
Ciprofloxacin HCl | Ciprofloxacin HCl
Sumatriptan | Sumatriptan
Bactrim | Bactrim
Asmanex 120 Metered Doses | Asmanex 120 Metered Doses
Inositol | Inositol
Docusate Sodium | Docusate Sodium
BuPROPion HCl (XL) | BuPROPion HCl (XL)
Cefpodoxime Proxetil | Cefpodoxime Proxetil
Pulmicort Flexhaler | Pulmicort Flexhaler
Apri | Apri
TobraDex | TobraDex
Artificial Tears | Artificial Tears
Lidocaine | Lidocaine
Copper | Copper
Clonidine HCl | Clonidine HCl
Compound W | Compound W
Nizoral | Nizoral
Haldol | Haldol
Antacid Regular | Antacid Regular
Cranberry | Cranberry
Lantus | Lantus
NovoLog | NovoLog
Apidra SoloStar | Apidra SoloStar
Auralgan | Auralgan
Robitussin DM Sugar Free | Robitussin DM Sugar Free
Vaporizer | Vaporizer
Benzaclin with Pump | Benzaclin with Pump
Neomycin-Polymyxin-HC | Neomycin-Polymyxin-HC
Mometasone-Ammonium Lactate | Mometasone-Ammonium Lactate
Metamucil | Metamucil
DiphenhydrAMINE HCl (Sleep) | DiphenhydrAMINE HCl (Sleep)
Simethicone-80 | Simethicone-80
Maalox Childrens | Maalox Childrens
Acidophilus | Acidophilus
Ferrous Gluconate | Ferrous Gluconate
Robitussin CF | Robitussin CF
Fluoxetine HCl | Fluoxetine HCl
Anaprox | Anaprox
Ex-Lax | Ex-Lax
Emetrol | Emetrol
Propranolol HCl | Propranolol HCl
Naphcon-A | Naphcon-A
Nexplanon | Nexplanon
Albuterol solution | Albuterol solution
Salicylic Acid-Benzoyl Perox | Salicylic Acid-Benzoyl Perox
Pseudoeph-Doxylamine-DM-APAP | Pseudoeph-Doxylamine-DM-APAP
Elimite | Elimite
Betamethasone Valerate | Betamethasone Valerate
Drisdol | Drisdol
Calcium 500 + D | Calcium 500 + D
Dayquil | Dayquil
Depakote | Depakote
Thermometer | Thermometer
Aspirin | Aspirin
Oxycodone HCl | Oxycodone HCl
Medications not entered | Medications not entered
Esomeprazole Magnesium | Esomeprazole Magnesium
Metformin &amp; Diet Manage Prod | Metformin &amp; Diet Manage Prod
RA Allergy | RA Allergy
Aviane | Aviane
Bactroban Nasal | Bactroban Nasal
Mupirocin Calcium | Mupirocin Calcium
Maalox Advanced | Maalox Advanced
PreNatal Vitamins Plus | PreNatal Vitamins Plus
Prevpac | Prevpac
Humidifier | Humidifier
Air Permeable Underpad | Air Permeable Underpad
Diapers &amp; Supplies | Diapers &amp; Supplies
Protonix | Protonix
Afrin 12 Hour | Afrin 12 Hour
Augmentin XR | Augmentin XR
Chloraseptic Sore Throat | Chloraseptic Sore Throat
Robitussin Childrens Cough LA | Robitussin Childrens Cough LA
Neutrogena Facial Soap | Neutrogena Facial Soap
Multi-Vitamin Daily | Multi-Vitamin Daily
Promethazine-Codeine | Promethazine-Codeine
Magnesium | Magnesium
Naprosyn | Naprosyn
Diclofenac Sodium | Diclofenac Sodium
Accutane | Accutane
CVS Vitamin D3 | CVS Vitamin D3
Mefloquine HCl | Mefloquine HCl
Ocuflox | Ocuflox
Fleet Enema | Fleet Enema
Fluticasone Propionate  HFA | Fluticasone Propionate  HFA
Mult-Vitamin/Fluoride | Mult-Vitamin/Fluoride
Childrens Chewable Multi Vits | Childrens Chewable Multi Vits
Advair HFA | Advair HFA
NyQuil | NyQuil
Augmentin ES-600 | Augmentin ES-600
Pseudoephedrine-Guaifenesin CR | Pseudoephedrine-Guaifenesin CR
Triple Antibiotic | Triple Antibiotic
Anusol-HC | Anusol-HC
Felbatol | Felbatol
Cholecalciferol-Vitamin C | Cholecalciferol-Vitamin C
Cool Mist Humidifier | Cool Mist Humidifier
BusPIRone HCl | BusPIRone HCl
Wellbutrin SR | Wellbutrin SR
Advil Cold/Sinus | Advil Cold/Sinus
Multi Complete | Multi Complete
Metadate CD | Metadate CD
Mobic | Mobic
Cyclobenzaprine HCl | Cyclobenzaprine HCl
Voltaren | Voltaren
Robitussin Child Cough/Cold CF | Robitussin Child Cough/Cold CF
Multi-Vitamin | Multi-Vitamin
Microgestin FE 1.5/30 | Microgestin FE 1.5/30
Robitussin Chest Congestion | Robitussin Chest Congestion
Dextromethorphan-Guaifenesin | Dextromethorphan-Guaifenesin
Naproxen DR | Naproxen DR
Sumatriptan Succinate | Sumatriptan Succinate
Linzess | Linzess
Delsym | Delsym
Citracal + D | Citracal + D
Lidocaine HCl | Lidocaine HCl
Dimetapp | Dimetapp
Vigamox | Vigamox
Malathion | Malathion
Nix Creme Rinse | Nix Creme Rinse
Claritin-D 24 Hour | Claritin-D 24 Hour
Antacid Anti-Gas | Antacid Anti-Gas
Hyoscyamine | Hyoscyamine
Multi For Her | Multi For Her
Opcicon One-Step | Opcicon One-Step
ProAir HFA | ProAir HFA
Multiple Vitamins | Multiple Vitamins
Desogestrel-Ethinyl Estradiol | Desogestrel-Ethinyl Estradiol
Tessalon Perles | Tessalon Perles
Elocon | Elocon
Iron (Ferrous Gluconate) | Iron (Ferrous Gluconate)
Childrens Multivitamin | Childrens Multivitamin
Clotrimazole 3 | Clotrimazole 3
Lactobacillus | Lactobacillus
Womens Multi | Womens Multi
Womens Multivitamin Plus | Womens Multivitamin Plus
Klonopin | Klonopin
Theraflu Cold &amp; Cough | Theraflu Cold &amp; Cough
Neutrogena Oil-Free Acne Wash | Neutrogena Oil-Free Acne Wash
Advil Migraine | Advil Migraine
ACE Knee Brace Small/Medium | ACE Knee Brace Small/Medium
CVS Hydrocortisone | CVS Hydrocortisone
Monistat 1 Combo Pack | Monistat 1 Combo Pack
Mylanta | Mylanta
Neomycin-Polymyxin-Gramicidin | Neomycin-Polymyxin-Gramicidin
Antibiotic | Antibiotic
Elestat | Elestat
Robaxin | Robaxin
Fioricet | Fioricet
Zantac 75 | Zantac 75
Nutrament | Nutrament
Tylenol PM Extra Strength | Tylenol PM Extra Strength
Clobetasol Prop Emollient Base | Clobetasol Prop Emollient Base
Focalin XR | Focalin XR
Prilosec OTC | Prilosec OTC
Lansoprazole | Lansoprazole
Lactaid Fast Act | Lactaid Fast Act
Prilosec | Prilosec
OCP | OCP
Nitrofurantoin Monohyd Macro | Nitrofurantoin Monohyd Macro
Prenatal Plus | Prenatal Plus
Terconazole | Terconazole
Lactobacillus Bifidus | Lactobacillus Bifidus
Silver Sulfadiazine | Silver Sulfadiazine
Focalin | Focalin
Xolegel Duo/Xolex | Xolegel Duo/Xolex
Skyla | Skyla
Imodium A-D | Imodium A-D
Multi Vitamin Daily | Multi Vitamin Daily
Tobramycin Sulfate | Tobramycin Sulfate
Misc. Devices | Misc. Devices
Misc Natural Product | Misc Natural Product
Florastor Kids | Florastor Kids
Artificial Tear Solution | Artificial Tear Solution
Norinyl 1+35 (28) | Norinyl 1+35 (28)
Doxycycline Monohydrate | Doxycycline Monohydrate
Zenatane | Zenatane
Xopenex | Xopenex
Locoid Lipocream | Locoid Lipocream
Acne Medication | Acne Medication
Sulfacetamide Sodium (Acne) | Sulfacetamide Sodium (Acne)
Vita-Plus E | Vita-Plus E
Vaseline | Vaseline
Cetirizine-Pseudoephedrine ER | Cetirizine-Pseudoephedrine ER
Trileptal | Trileptal
Falmina | Falmina
Spacer/Aero Chamber Mouthpiece | Spacer/Aero Chamber Mouthpiece
Wheelchair | Wheelchair
Flonase Allergy Relief | Flonase Allergy Relief
Physical Therapy | Physical Therapy
Chlorhexidine | Chlorhexidine
Tobrex | Tobrex
Epiduo | Epiduo
Fexofenadine-Pseudoephed ER | Fexofenadine-Pseudoephed ER
Cyanocobalamin | Cyanocobalamin
Podofilox | Podofilox
Eye Allergy Relief | Eye Allergy Relief
Ginger | Ginger
Unisom | Unisom
Albendazole | Albendazole
Ondansetron HCl | Ondansetron HCl
Prenatal Multivitamin + DHA | Prenatal Multivitamin + DHA
Reclipsen | Reclipsen
Yasmin 28 | Yasmin 28
Moxifloxacin HCl (2X Day) | Moxifloxacin HCl (2X Day)
Vaseline Intensive Care | Vaseline Intensive Care
Carbamide Peroxide | Carbamide Peroxide
Selsun Blue | Selsun Blue
Selsun Blue Dry Scalp | Selsun Blue Dry Scalp
Zatean-Pn DHA | Zatean-Pn DHA
Gabapentin | Gabapentin
Olopatadine HCl | Olopatadine HCl
Crutch | Crutch
Ponstel | Ponstel
Dimaphen DM Cold/Cough | Dimaphen DM Cold/Cough
Multi Complete/Iron | Multi Complete/Iron
Fiber | Fiber
FiberCon | FiberCon
Lotrimin AF Powder | Lotrimin AF Powder
Aveeno Eczema Therapy | Aveeno Eczema Therapy
Carpal Tunnel Wrist Stabilizer | Carpal Tunnel Wrist Stabilizer
Breezee Mist | Breezee Mist
Cystex | Cystex
Methylphenidate HCl | Methylphenidate HCl
Xulane | Xulane
Omnicef | Omnicef
Strattera | Strattera
Preparation H | Preparation H
Ketoconazole-Hydrocortisone | Ketoconazole-Hydrocortisone
RepHresh | RepHresh
Vandazole | Vandazole
ChlorproMAZINE | ChlorproMAZINE
Tolnaftate | Tolnaftate
Ketoconazole-Cleanser | Ketoconazole-Cleanser
Tylenol Extra Strength | Tylenol Extra Strength
Cyclafem 1/35 | Cyclafem 1/35
Triamcinolone | Triamcinolone
Toradol Oral | Toradol Oral
Gardasil | Gardasil
Acetaminophen 8 Hour | Acetaminophen 8 Hour
Chlorthalidone | Chlorthalidone
Lubricant Eye Drops | Lubricant Eye Drops
Ankle Brace/High Performance M | Ankle Brace/High Performance M
Jublia | Jublia
GlyBURIDE | GlyBURIDE
Biotin | Biotin
Hydrogen Peroxide | Hydrogen Peroxide
Nystatin | Nystatin
Toe Spacer | Toe Spacer
Calamine | Calamine
Ivermectin | Ivermectin
Tussin | Tussin
Cepacol Sore Throat + Coating | Cepacol Sore Throat + Coating
Aveeno Anti-Itch | Aveeno Anti-Itch
Nebulizer Air Tube/Plugs | Nebulizer Air Tube/Plugs
Sudafed PE Cold/Cough | Sudafed PE Cold/Cough
B6 Natural | B6 Natural
Icy Hot | Icy Hot
PredniSONE (Pak) | PredniSONE (Pak)
Calamine Phenolated | Calamine Phenolated
Microgestin 1.5/30 | Microgestin 1.5/30
Vyvanse | Vyvanse
Clotrimazole AF | Clotrimazole AF
Robitussin Cold/Congestion | Robitussin Cold/Congestion
Pedi-Dri | Pedi-Dri
Saline Sensitive Eyes | Saline Sensitive Eyes
Polymyxin B-Trimethoprim | Polymyxin B-Trimethoprim
Midol Cramp Formula Max St | Midol Cramp Formula Max St
Multivitamin Adult | Multivitamin Adult
Chlorpheniramine-Phenylephrine | Chlorpheniramine-Phenylephrine
Delsym Nght Time Cgh/Cld Child | Delsym Nght Time Cgh/Cld Child
Clarinex-D 24 Hour | Clarinex-D 24 Hour
Junel FE 1.5/30 | Junel FE 1.5/30
Gildess FE 1.5/30 | Gildess FE 1.5/30
MetFORMIN HCl ER (MOD) | MetFORMIN HCl ER (MOD)
Divalproex Sodium | Divalproex Sodium
Thera Tears Allergy | Thera Tears Allergy
Fluorometholone | Fluorometholone
Aloe Vera Moisturizing | Aloe Vera Moisturizing
Mentax | Mentax
Eucerin | Eucerin
DM-Phenylephrine-Acetaminophen | DM-Phenylephrine-Acetaminophen
Sudafed PE | Sudafed PE
Claritin Eye | Claritin Eye
Biaxin XL | Biaxin XL
Daily-Vite/Iron | Daily-Vite/Iron
Mylanta Gas | Mylanta Gas
Multi For Him | Multi For Him
Flovent Diskus | Flovent Diskus
Spacer/Aero-Holding Chambers | Spacer/Aero-Holding Chambers
Theraflu Cold &amp; Sore Throat | Theraflu Cold &amp; Sore Throat
Terbinafine | Terbinafine
Aripiprazole | Aripiprazole
Robitussin Cough+Chest Cong DM | Robitussin Cough+Chest Cong DM
Midol | Midol
Clean &amp; Clear Continuous Wash | Clean &amp; Clear Continuous Wash
Portia-28 | Portia-28
EPINEPHrine | EPINEPHrine
Omega-3 Fish Oil | Omega-3 Fish Oil
Calcium 600 + D | Calcium 600 + D
Brompheniramine-Phenylephrine | Brompheniramine-Phenylephrine
Elastic Ankle Support | Elastic Ankle Support
Tobramycin | Tobramycin
Acticin | Acticin
Seasonique | Seasonique
Elidel | Elidel
Bentyl | Bentyl
Moxatag | Moxatag
Auvi-Q | Auvi-Q
Prednisone | Prednisone
Rondec DM | Rondec DM
Epinastine HCl | Epinastine HCl
Omega-3 | Omega-3
Guaifenesin-DM | Guaifenesin-DM
Senna Lax | Senna Lax
Ex-Lax Maximum Strength | Ex-Lax Maximum Strength
Sulfacetamide Sodium-Sulfur | Sulfacetamide Sodium-Sulfur
Multivitamin Gummies Adult | Multivitamin Gummies Adult
Lidocaine HCl (Local Anesth.) | Lidocaine HCl (Local Anesth.)
Guanfacine HCl | Guanfacine HCl
Ativan | Ativan
Tegretol | Tegretol
Lithium Carbonate | Lithium Carbonate
Lorazepam | Lorazepam
Sertraline HCl | Sertraline HCl
Blood Press Monitor/M-L Cuff | Blood Press Monitor/M-L Cuff
Humira | Humira
Methotrexate | Methotrexate
Norelgestromin-Eth Estradiol | Norelgestromin-Eth Estradiol
ampiciilin | ampiciilin
Albuterol MDI | Albuterol MDI
Selenium Sulfide | Selenium Sulfide
Kaopectate Extra Strength | Kaopectate Extra Strength
Mediplast | Mediplast
Clindamycin-Benzoyl Per-Moist | Clindamycin-Benzoyl Per-Moist
Tuberculin PPD | Tuberculin PPD
Celebrex | Celebrex
Calcium-Vitamin D3 | Calcium-Vitamin D3
Acetaminophen-Guaifenesin | Acetaminophen-Guaifenesin
Midol Teen | Midol Teen
Moxifloxacin HCl | Moxifloxacin HCl
Wrist Brace Ultra-Lite | Wrist Brace Ultra-Lite
Factor XIII Concentrate Human | Factor XIII Concentrate Human
Ensure Nutrition Shake | Ensure Nutrition Shake
Megestrol Acetate | Megestrol Acetate
Norditropin | Norditropin
NyQuil Multi-Symptom | NyQuil Multi-Symptom
Tinactin Foot/Sneaker Deodor | Tinactin Foot/Sneaker Deodor
Chest Congestion/Cough Relief | Chest Congestion/Cough Relief
Hydrocortisone-Iodoquinol | Hydrocortisone-Iodoquinol
Clindamycin-Benzoyl Per-Cleans | Clindamycin-Benzoyl Per-Cleans
Ciclopirox Olamine | Ciclopirox Olamine
Ciclopirox Treatment | Ciclopirox Treatment
Benzac AC | Benzac AC
Latuda | Latuda
Cefadroxil | Cefadroxil
Zantac EFFERdose | Zantac EFFERdose
Biaxin | Biaxin
Zyrtec-D Allergy &amp; Congestion | Zyrtec-D Allergy &amp; Congestion
Influenza Virus Vacc Split PF | Influenza Virus Vacc Split PF
Astepro | Astepro
Azelastine-Fluticasone | Azelastine-Fluticasone
Mens Multi Vitamin &amp; Mineral | Mens Multi Vitamin &amp; Mineral
Daily Multiple Vitamins/Iron | Daily Multiple Vitamins/Iron
Ketorolac Tromethamine | Ketorolac Tromethamine
Prenatal Vitamin | Prenatal Vitamin
Blood Glucose Monitor System | Blood Glucose Monitor System
Blood Glucose Test | Blood Glucose Test
Vi-Cert C500 | Vi-Cert C500
Daily Vite | Daily Vite
Ipratropium Bromide | Ipratropium Bromide
Aqueous Vitamin D | Aqueous Vitamin D
Bone Meal-Vitamin D | Bone Meal-Vitamin D
Migranal | Migranal
Omega 3 | Omega 3
Verapamil HCl | Verapamil HCl
Bayer Aspirin | Bayer Aspirin
Calcium 1200 | Calcium 1200
Zyrtec Childrens Allergy | Zyrtec Childrens Allergy
Norethindrone | Norethindrone
Mucinex Child Cold | Mucinex Child Cold
Nutropin | Nutropin
Premarin | Premarin
Meloxicam | Meloxicam
PediaSure Pediatric | PediaSure Pediatric
Kenalog | Kenalog
Fiber Select Gummies | Fiber Select Gummies
Pepcid AC | Pepcid AC
Pediatric Multiple Vit-C-FA | Pediatric Multiple Vit-C-FA
Poly-Vita/Iron | Poly-Vita/Iron
DayQuil Multi-Symptom | DayQuil Multi-Symptom
Hydrocortisone Butyr Lipo Base | Hydrocortisone Butyr Lipo Base
Doxylamine Succinate (Sleep) | Doxylamine Succinate (Sleep)
Cortisporin-TC | Cortisporin-TC
Eye Wash | Eye Wash
Ferrex 150 | Ferrex 150
Aerospan | Aerospan
Cool Mist Humidifier 2 gallon | Cool Mist Humidifier 2 gallon
Boost Plus | Boost Plus
Aircast Sport Ankle Brace/Rght | Aircast Sport Ankle Brace/Rght
Lysteda | Lysteda
Tranexamic Acid | Tranexamic Acid
Adult Mask | Adult Mask
Amoxicillin-Pot Clavulanate ER | Amoxicillin-Pot Clavulanate ER
Mens Multivitamin Plus | Mens Multivitamin Plus
Cefuroxime Axetil | Cefuroxime Axetil
Nasal Moist | Nasal Moist
ACE Knee Brace Hinged | ACE Knee Brace Hinged
Knee Brace | Knee Brace
Clobetasol Propionate Emulsion | Clobetasol Propionate Emulsion
Norgestimate-Eth Estradiol | Norgestimate-Eth Estradiol
Full Kit Nebulizer Set | Full Kit Nebulizer Set
Robitussin Cough/Cold CF | Robitussin Cough/Cold CF
Rocephin | Rocephin
Aczone | Aczone
Metformin | Metformin
YAZ | YAZ
Duloxetine HCl | Duloxetine HCl
Childrens Pepto | Childrens Pepto
BL Ibuprofen | BL Ibuprofen
Nitrofurantoin | Nitrofurantoin
Prevacid SoluTab | Prevacid SoluTab
Risperidone | Risperidone
Ensure Complete | Ensure Complete
Drysol | Drysol
Adapalene-Benzoyl Peroxide | Adapalene-Benzoyl Peroxide
Talc | Talc
Tri-Vi-Sol | Tri-Vi-Sol
Spectazole | Spectazole
Briefs Overnight Medium | Briefs Overnight Medium
Adult Brief Medium | Adult Brief Medium
DIAPERS | DIAPERS
Sebulex | Sebulex
Centrum Kids Complete | Centrum Kids Complete
Multi Vit/Fl | Multi Vit/Fl
Childrens Ibuprofen | Childrens Ibuprofen
Levothroid | Levothroid
Balmex | Balmex
Desitin | Desitin
Zinc Oxide | Zinc Oxide
Dicloxacillin Sodium | Dicloxacillin Sodium
Trokendi XR | Trokendi XR
Loratadine-D 24HR | Loratadine-D 24HR
Robitussin Allergy/Cough | Robitussin Allergy/Cough
Delsym Night Time Cough/Cold | Delsym Night Time Cough/Cold
Scholls Advantage Arch Support | Scholls Advantage Arch Support
Baby Vitamin A &amp; D | Baby Vitamin A &amp; D
Acetaminophen-Codeine | Acetaminophen-Codeine
Clindamycin Palmitate HCl | Clindamycin Palmitate HCl
Levsin | Levsin
Salicylic Acid Wart Remover | Salicylic Acid Wart Remover
Labetalol HCl | Labetalol HCl
Mycophenolate Mofetil | Mycophenolate Mofetil
Prograf | Prograf
Sodium Bicarbonate | Sodium Bicarbonate
Valganciclovir HCl | Valganciclovir HCl
Nupercainal | Nupercainal
Aveeno Smoothing Body Wash | Aveeno Smoothing Body Wash
Robitussin Peak Cold DM | Robitussin Peak Cold DM
Methylphenidate HCl ER | Methylphenidate HCl ER
Clindamycin Phos &amp; Cleanser | Clindamycin Phos &amp; Cleanser
Plexion Cleanser | Plexion Cleanser
Clotrimazole Anti-Fungal | Clotrimazole Anti-Fungal
Tinactin Jock Itch | Tinactin Jock Itch
Nebulizer Mask Pediatric | Nebulizer Mask Pediatric
Fruity Chewables Multivitamin | Fruity Chewables Multivitamin
Ferrous Sulfate-Vitamin C | Ferrous Sulfate-Vitamin C
Sitz Bath | Sitz Bath
Vitamin B-12 | Vitamin B-12
Tylenol Chest Congestion | Tylenol Chest Congestion
Maalox Max | Maalox Max
Aveeno Act Nat Protect+Hydrate | Aveeno Act Nat Protect+Hydrate
Tretinoin (Emollient) | Tretinoin (Emollient)
Flintstones Gummies | Flintstones Gummies
DesOwen | DesOwen
DesOwen Lot w/Cetaphil Cream | DesOwen Lot w/Cetaphil Cream
DesOwen Oint w/Cetaphil Lot | DesOwen Oint w/Cetaphil Lot
Betadine | Betadine
Neutrogena Hand | Neutrogena Hand
Phenylephrine-Bromphen-DM | Phenylephrine-Bromphen-DM
EPINEPHrine HCl (Anaphylaxis) | EPINEPHrine HCl (Anaphylaxis)
Tretin-X | Tretin-X
VCF Vaginal Contraceptive | VCF Vaginal Contraceptive
Noble Formula HC | Noble Formula HC
Ranitidine Acid Reducer | Ranitidine Acid Reducer
Hydrocortisone Acetate | Hydrocortisone Acetate
Allegra-D 12 Hour | Allegra-D 12 Hour
Condoms | Condoms
Creon | Creon
Tobi Podhaler | Tobi Podhaler
Cough Drops | Cough Drops
Nasal Saline | Nasal Saline
Citalopram Hydrobromide | Citalopram Hydrobromide
Multi-Vits/Fluoride | Multi-Vits/Fluoride
Ranitidine 75 | Ranitidine 75
Silvadene | Silvadene
Vit E-Vit C-Beta Carotene | Vit E-Vit C-Beta Carotene
Nasal Moisturizer | Nasal Moisturizer
NyQuil Cold &amp; Flu | NyQuil Cold &amp; Flu
Sodium Chloride | Sodium Chloride
Cepacol Sore Throat Max Numb | Cepacol Sore Throat Max Numb
CeraVe | CeraVe
Multivitamin &amp; Mineral | Multivitamin &amp; Mineral
Multivitamin Men | Multivitamin Men
Azelaic Acid-Cleanser-Lotion | Azelaic Acid-Cleanser-Lotion
Vitamin D3 Adult Gummies | Vitamin D3 Adult Gummies
Ear Drops Earwax Aid | Ear Drops Earwax Aid
Cold Caplets | Cold Caplets
Multi-Day | Multi-Day
Robitussin Cold &amp; Cough | Robitussin Cold &amp; Cough
Aveeno Creamy Moisturizing | Aveeno Creamy Moisturizing
Ondansetron | Ondansetron
Insulin Infusion Pump | Insulin Infusion Pump
Humalog | Humalog
Cortisone | Cortisone
FESO4 | FESO4
Proctozone-HC | Proctozone-HC
Knee Brace/Flex Stays Medium | Knee Brace/Flex Stays Medium
Nasacort Allergy 24HR | Nasacort Allergy 24HR
Childs Ibuprofen | Childs Ibuprofen
Wart Remover | Wart Remover
Clean &amp; Clear Continuous | Clean &amp; Clear Continuous
Neutrogena Acne Cleansing Soap | Neutrogena Acne Cleansing Soap
Neutrogena Moisture Sens Skin | Neutrogena Moisture Sens Skin
Miconazole 7 | Miconazole 7
Cold Multi-Symptom | Cold Multi-Symptom
Polyethylene Glycol | Polyethylene Glycol
Abdominal Support 2X/3X Large | Abdominal Support 2X/3X Large
Tucks | Tucks
Loratadine Childrens | Loratadine Childrens
Naphazoline-Pheniramine | Naphazoline-Pheniramine
APAP | APAP
Depakene | Depakene
Flintstones Plus Calcium | Flintstones Plus Calcium
Calcium Gummies | Calcium Gummies
Calcium 1200+D3 | Calcium 1200+D3
Antipyrine-Benzocaine | Antipyrine-Benzocaine
Ayr Saline Nasal Drops | Ayr Saline Nasal Drops
Methylphenidate HCl ER (CD) | Methylphenidate HCl ER (CD)
Quetiapine Fumarate | Quetiapine Fumarate
Brompheniramine-Pseudoeph | Brompheniramine-Pseudoeph
Calcium Carbonate-Vit D-Min | Calcium Carbonate-Vit D-Min
Cetirizine HCl Allergy Child | Cetirizine HCl Allergy Child
Ankle Foot Orthosis (Left) | Ankle Foot Orthosis (Left)
Ankle Foot Orthosis (Right) | Ankle Foot Orthosis (Right)
Pediatric Multiple Vitamins | Pediatric Multiple Vitamins
Nexcare Opticlude Patch | Nexcare Opticlude Patch
Cetaphil Moisturizing | Cetaphil Moisturizing
Trimethoprim-Sulfamethoxazole | Trimethoprim-Sulfamethoxazole
Doxycycline | Doxycycline
Doxycycline Calcium | Doxycycline Calcium
Trimethoprim HCl | Trimethoprim HCl
Nix Complete Lice System | Nix Complete Lice System
Hot &amp; Cold Wrap/Gel Pack | Hot &amp; Cold Wrap/Gel Pack
Progesterone | Progesterone
Spironolactone | Spironolactone
AeroChamber MAX w/Flow-VU | AeroChamber MAX w/Flow-VU
Vitamin D-400 | Vitamin D-400
Betadine Swabsticks | Betadine Swabsticks
Senokot | Senokot
Robitussin Cold+Flu Daytime | Robitussin Cold+Flu Daytime
Atrovent | Atrovent
Fungoid Tincture | Fungoid Tincture
AeroChamber MAX w/Mask Medium | AeroChamber MAX w/Mask Medium
Loperamide HCl | Loperamide HCl
Diastat Pediatric | Diastat Pediatric
Levalbuterol HCl | Levalbuterol HCl
Xopenex HFA | Xopenex HFA
Budesonide | Budesonide
Psyllium | Psyllium
Pseudoeph-Bromphen-DM | Pseudoeph-Bromphen-DM
Sarna | Sarna
Glycerin (Pediatric) | Glycerin (Pediatric)
Cimetidine | Cimetidine
Imiquimod | Imiquimod
Complete Multivitamin/Mineral | Complete Multivitamin/Mineral
Olux | Olux
Diflorasone Diacetate | Diflorasone Diacetate
Multivitamin/Minerals | Multivitamin/Minerals
Nebulizer/Tubing/Mouthpiece | Nebulizer/Tubing/Mouthpiece
Multivitamin Gummies Womens | Multivitamin Gummies Womens
Rhinocort Aqua | Rhinocort Aqua
Daily Multivitamin | Daily Multivitamin
Lamotrigine | Lamotrigine
Menthol (Topical Analgesic) | Menthol (Topical Analgesic)
Diastat Adult | Diastat Adult
MetFORMIN HCl ER | MetFORMIN HCl ER
One Touch Lancets | One Touch Lancets
one touch ultra glucometer | one touch ultra glucometer
One Touch Ultra Test Strips | One Touch Ultra Test Strips
Glucagon Emergency | Glucagon Emergency
Vitamin D3 Maximum Strength | Vitamin D3 Maximum Strength
Doxy 100 | Doxy 100
Pari LC Plus Nebulizer | Pari LC Plus Nebulizer
Phenazopyridine HCl | Phenazopyridine HCl
Acapella | Acapella
Aldara | Aldara
Multi Vitamin Mens | Multi Vitamin Mens
Orajel | Orajel
Systane Ultra | Systane Ultra
Oral Pain Relief | Oral Pain Relief
Robitussin Child Cough/Cold LA | Robitussin Child Cough/Cold LA
Nasal Spray | Nasal Spray
PSE 15/CPM 2 | PSE 15/CPM 2
Clindamycin-Benzoyl Per (Refr) | Clindamycin-Benzoyl Per (Refr)
Chlorpheniramine-DM | Chlorpheniramine-DM
Cool Mist Humidifier 1 gallon | Cool Mist Humidifier 1 gallon
Ortho Micronor | Ortho Micronor
Ceftriaxone Sodium | Ceftriaxone Sodium
Abdominal Binder/Elastic Small | Abdominal Binder/Elastic Small
BuPROPion HCl (SR) | BuPROPion HCl (SR)
Fer-In-Sol | Fer-In-Sol
Saline Flush | Saline Flush
Jolivette | Jolivette
Spacer/Aero-Hold Chamber Mask | Spacer/Aero-Hold Chamber Mask
Salex | Salex
Cipro HC | Cipro HC
Alka-Seltzer | Alka-Seltzer
Childrens Chew Vit/Minerals | Childrens Chew Vit/Minerals
Calcium 500 | Calcium 500
Aveeno Advanced Care Body Wash | Aveeno Advanced Care Body Wash
Hypercare | Hypercare
Gardasil 9 | Gardasil 9
Calcium-Folic Acid Plus D | Calcium-Folic Acid Plus D
Ethosuximide | Ethosuximide
Afrin Nasal Spray | Afrin Nasal Spray
CompAir Nebulizer | CompAir Nebulizer
Amphetamine Salt Combo | Amphetamine Salt Combo
Clonazepam ODT | Clonazepam ODT
Childrens Mucus Relief Cough | Childrens Mucus Relief Cough
Dexedrine | Dexedrine
Eucerin Eczema Relief | Eucerin Eczema Relief
Actos | Actos
Zetia | Zetia
Mucinex Fast-Max Cold Flu | Mucinex Fast-Max Cold Flu
Childrens Multi-Vits/Iron | Childrens Multi-Vits/Iron
Vistaril | Vistaril
Childrens Chewable Vitamins/Fe | Childrens Chewable Vitamins/Fe
Desonate | Desonate
Fluocinolone Acetonide | Fluocinolone Acetonide
PediaSure/Fiber | PediaSure/Fiber
Exjade | Exjade
Oral Analgesic Max St | Oral Analgesic Max St
Boost | Boost
RID | RID
depoprovera | depoprovera
Chloraseptic Max Sore Throat | Chloraseptic Max Sore Throat
Cetirizine HCl Childrens Alrgy | Cetirizine HCl Childrens Alrgy
Cetaphil Antibacterial | Cetaphil Antibacterial
Cetaphil Gentle Cleansing | Cetaphil Gentle Cleansing
Siltussin DM Alcohol Free | Siltussin DM Alcohol Free
Calcium &amp; Vit D3 Bone Health | Calcium &amp; Vit D3 Bone Health
Tums | Tums
Omega-3 Fatty Acids | Omega-3 Fatty Acids
Lantus Solostar Pen | Lantus Solostar Pen
TRUEresult Blood Glucose | TRUEresult Blood Glucose
Apidra | Apidra
Bayer Contour Test | Bayer Contour Test
Pen Needles 5/16" | Pen Needles 5/16"
Alcohol Wipes | Alcohol Wipes
Ketostix | Ketostix
TRUEplus Lancets 33G | TRUEplus Lancets 33G
TrueTrack Test | TrueTrack Test
MetFORMIN HCl ER (OSM) | MetFORMIN HCl ER (OSM)
Derma-Smoothe/FS Body | Derma-Smoothe/FS Body
CVS Senna | CVS Senna
Pulmozyme | Pulmozyme
Magnesium Hydroxide | Magnesium Hydroxide
Lipitor | Lipitor
Miconazole 3 | Miconazole 3
Fexofenadine HCl Childrens | Fexofenadine HCl Childrens
Poly-Vi-Sol/Iron | Poly-Vi-Sol/Iron
Omeprazole Magnesium | Omeprazole Magnesium
Lac-Hydrin Five | Lac-Hydrin Five
Tylenol Cold/Flu Severe | Tylenol Cold/Flu Severe
Ipratropium-Albuterol | Ipratropium-Albuterol
CVS Ibuprofen IB | CVS Ibuprofen IB
Polyvitamin | Polyvitamin
Carbamazepine | Carbamazepine
Docosanol | Docosanol
Childrens Cough | Childrens Cough
Al &amp; Mag Hyd-Ca Carb-Simeth | Al &amp; Mag Hyd-Ca Carb-Simeth
Cefixime | Cefixime
Gly-Oxide | Gly-Oxide
Cabergoline | Cabergoline
Aveeno Anti-Itch Max St | Aveeno Anti-Itch Max St
Finger Splint | Finger Splint
Clean &amp; Clear Advantage Wash | Clean &amp; Clear Advantage Wash
FML | FML
BenzaClin Care | BenzaClin Care
Aleve | Aleve
Qnasl | Qnasl
Xyzal | Xyzal
Zyrtec-D | Zyrtec-D
Nitrofurantoin Macrocrystal | Nitrofurantoin Macrocrystal
Virasal | Virasal
Calcium 600-D | Calcium 600-D
Tolnaftate Antifungal | Tolnaftate Antifungal
Ankle Foot Orthoses (Bilateral | Ankle Foot Orthoses (Bilateral
Olanzapine | Olanzapine
Neosporin + Pain Relief Max St | Neosporin + Pain Relief Max St
Orapred | Orapred
Vitamin B Complex | Vitamin B Complex
Spacer/Aero-Hold Chamber Bags | Spacer/Aero-Hold Chamber Bags
Multivitamins Pediatric | Multivitamins Pediatric
Lomotil | Lomotil
Imodium Multi-Symptom Relief | Imodium Multi-Symptom Relief
Insulin Cartridge 3ML | Insulin Cartridge 3ML
Opcon-A | Opcon-A
Oxcarbazepine | Oxcarbazepine
Clotrimazole 3 Day | Clotrimazole 3 Day
Alka-Seltzer Plus Cold | Alka-Seltzer Plus Cold
elavil | elavil
Catheters | Catheters
Normal Saline Solution | Normal Saline Solution
Aveeno Clear Complexion | Aveeno Clear Complexion
Neutrogena | Neutrogena
Nebulizer/Pediatric Mask | Nebulizer/Pediatric Mask
Knee Support/Open Patella Med | Knee Support/Open Patella Med
Petroleum Jelly | Petroleum Jelly
Mens Multiple Vitamin/Lycopene | Mens Multiple Vitamin/Lycopene
Child Ibuprofen | Child Ibuprofen
Lotrimin AF Jock Itch Powder | Lotrimin AF Jock Itch Powder
Mylanta Double-Strength | Mylanta Double-Strength
Multivitamin/Fluoride | Multivitamin/Fluoride
Trusopt | Trusopt
Monistat 3 | Monistat 3
Floxin Otic | Floxin Otic
Cortisone Acetate | Cortisone Acetate
Solu-Cortef | Solu-Cortef
Mederma Stretch Marks Therapy | Mederma Stretch Marks Therapy
One-Daily Multivitamins | One-Daily Multivitamins
Hydrocortisone Ace-Aloe Vera | Hydrocortisone Ace-Aloe Vera
Aluminum-Magnesium-Simethicone | Aluminum-Magnesium-Simethicone
Calcium-Vitamin D-Minerals | Calcium-Vitamin D-Minerals
Fluorescein Sodium | Fluorescein Sodium
Allergy Med | Allergy Med
Nasal Allergy | Nasal Allergy
Mebendazole | Mebendazole
Artificial Tear Ointment | Artificial Tear Ointment
Refresh Optive | Refresh Optive
Refresh Lacri-Lube | Refresh Lacri-Lube
Carbonyl Iron | Carbonyl Iron
Dextromethorphan Polistirex ER | Dextromethorphan Polistirex ER
Mucinex Cough Childrens | Mucinex Cough Childrens
Pedia-Lax Probiotic Yums | Pedia-Lax Probiotic Yums
NuLev | NuLev
Synalar | Synalar
Penciclovir | Penciclovir
Multivitamin Gummies Childrens | Multivitamin Gummies Childrens
Imodium Advanced | Imodium Advanced
Lice Removal Combs | Lice Removal Combs
Lopid | Lopid
SinuCleanse Neti Pot | SinuCleanse Neti Pot
Chewable Vite Childrens | Chewable Vite Childrens
Fish Oil Burp-Less | Fish Oil Burp-Less
Calcipotriene | Calcipotriene
Ovide | Ovide
Probiotic | Probiotic
Junel 1.5/30 | Junel 1.5/30
Multiple Vitamins-Calcium | Multiple Vitamins-Calcium
Chlorhexidine Gluconate | Chlorhexidine Gluconate
Ankle Brace/Flexible Stays Med | Ankle Brace/Flexible Stays Med
Acne Cleanser Maximum Strength | Acne Cleanser Maximum Strength
Percocet | Percocet
Vitamin D2 | Vitamin D2
Baby Shampoo | Baby Shampoo
Vit D-Vit E-Safflower Oil | Vit D-Vit E-Safflower Oil
Benzocaine | Benzocaine
Robitussin Severe Congestion | Robitussin Severe Congestion
Easy Fiber | Easy Fiber
Stool Softener | Stool Softener
Peak Air Peak Flow Meter | Peak Air Peak Flow Meter
Bleph-10 | Bleph-10
Depo-Estradiol | Depo-Estradiol
Malarone | Malarone
Rhinaris | Rhinaris
Multiple Vitamin | Multiple Vitamin
Cetirizine HCl Childrens | Cetirizine HCl Childrens
Vicodin | Vicodin
Calcium 600+D3 | Calcium 600+D3
Elastic Knee Support | Elastic Knee Support
Nordette (28) | Nordette (28)
Norethin-Eth Estrad-Fe Biphas | Norethin-Eth Estrad-Fe Biphas
Underpads | Underpads
Vitamin D3 High Potency | Vitamin D3 High Potency
Bath/Shower Seat | Bath/Shower Seat
Lamisil AT | Lamisil AT
Chewable Multivite/Fluoride | Chewable Multivite/Fluoride
Clindamycin-Tretinoin | Clindamycin-Tretinoin
Doxycycline (Rosacea) | Doxycycline (Rosacea)
Retin-A Micro | Retin-A Micro
Claritin Reditabs | Claritin Reditabs
Culturelle Kids | Culturelle Kids
Selsun Blue Medicated | Selsun Blue Medicated
Motrin Infants Drops | Motrin Infants Drops
Biofreeze | Biofreeze
Cough &amp; Cold | Cough &amp; Cold
Methimazole | Methimazole
OptiChamber | OptiChamber
Alaway | Alaway
Childrens Chewable Vitamins | Childrens Chewable Vitamins
Hylatopic | Hylatopic
Artificial Tear | Artificial Tear
Epsom Salt | Epsom Salt
Blood Pressure Kit | Blood Pressure Kit
Amphetamine-Dextroamphet ER | Amphetamine-Dextroamphet ER
Calamine-Zinc Oxide | Calamine-Zinc Oxide
Lidocaine-Aloe Vera | Lidocaine-Aloe Vera
Oatmeal Bath Regular | Oatmeal Bath Regular
Advil Junior Strength | Advil Junior Strength
Triaminic Cold/Allergy | Triaminic Cold/Allergy
LAClotion | LAClotion
Lo/Ovral | Lo/Ovral
Nortrel 0.5/35 (28) | Nortrel 0.5/35 (28)
Clenia Foaming Wash | Clenia Foaming Wash
Trolamine Salicylate | Trolamine Salicylate
Miconazole Nitrate | Miconazole Nitrate
Clonidine | Clonidine
Doxepin HCl | Doxepin HCl
Cream Base | Cream Base
Tylenol Childrens Cold/Stuffy | Tylenol Childrens Cold/Stuffy
Comfort Fit Maternity Supp Sm | Comfort Fit Maternity Supp Sm
Cough Syrup | Cough Syrup
Citrucel | Citrucel
Prelone | Prelone
Sodium Chloride (Inhalant) | Sodium Chloride (Inhalant)
Tylenol Jr Meltaways | Tylenol Jr Meltaways
Flintstones Gummies Plus | Flintstones Gummies Plus
B-12 | B-12
Maalox Advanced Max St | Maalox Advanced Max St
Splint | Splint
Thumb Splint/Right Medium | Thumb Splint/Right Medium
Thumb Stabilizer/Right Medium | Thumb Stabilizer/Right Medium
Topicort | Topicort
Calcitriol | Calcitriol
Neutra-Phos | Neutra-Phos
Analgesic Balm | Analgesic Balm
Wrist Brace/Right Small | Wrist Brace/Right Small
A &amp; D Zinc Oxide | A &amp; D Zinc Oxide
Naphazoline HCl | Naphazoline HCl
Clean &amp; Clear Acne Treatment | Clean &amp; Clear Acne Treatment
Vitamin E/D-Alpha Natural | Vitamin E/D-Alpha Natural
Calcium 600 + Minerals | Calcium 600 + Minerals
Lindane | Lindane
Calcium 600/Vitamin D3 | Calcium 600/Vitamin D3
Wellbutrin | Wellbutrin
Lubricating Eye Drops | Lubricating Eye Drops
AeroChamber MV | AeroChamber MV
BD Thermometer | BD Thermometer
BD Thermometer Oral | BD Thermometer Oral
Thermometer/Memory | Thermometer/Memory
Luxiq | Luxiq
Benadryl Anti-Itch Childrens | Benadryl Anti-Itch Childrens
Aveeno Daily Moisturizing | Aveeno Daily Moisturizing
Bacitra-Neomycin-Polymyxin-HC | Bacitra-Neomycin-Polymyxin-HC
dacriose opth drops | dacriose opth drops
Alka-Seltzer Plus Cold &amp; Flu | Alka-Seltzer Plus Cold &amp; Flu
Tylenol Cold Multi-Symptom Day | Tylenol Cold Multi-Symptom Day
Flintstones Gummies Bone Build | Flintstones Gummies Bone Build
Childrens Multivitamin/Iron | Childrens Multivitamin/Iron
Elastic Bandage 2" | Elastic Bandage 2"
Suprax | Suprax
Ibuprofen Junior Strength | Ibuprofen Junior Strength
Chewables Multivitamin | Chewables Multivitamin
Moisture | Moisture
Intuniv | Intuniv
Dimetapp Night Cold/Congestion | Dimetapp Night Cold/Congestion
Neosporin Original | Neosporin Original
Acular | Acular
Calcium Carbonate Antacid | Calcium Carbonate Antacid
Chestal Honey Cough | Chestal Honey Cough
Phenobarbital | Phenobarbital
Diazepam | Diazepam
PrednisoLONE Sodium Phosphate | PrednisoLONE Sodium Phosphate
Childrens Tylenol Plus | Childrens Tylenol Plus
Childrens Multivitamins | Childrens Multivitamins
Wrist Brace/Right Medium | Wrist Brace/Right Medium
Calcium + D3 | Calcium + D3
Clobetasol Propionate E | Clobetasol Propionate E
Dulcolax Milk of Magnesia | Dulcolax Milk of Magnesia
Flintstones Plus Iron | Flintstones Plus Iron
Zanaflex | Zanaflex
Lamictal Starter | Lamictal Starter
LamoTRIgine ER | LamoTRIgine ER
Peptamen | Peptamen
Robinul | Robinul
Sterile Water | Sterile Water
Tobi | Tobi
Enteral Pump Set | Enteral Pump Set
Feeding Tubes | Feeding Tubes
Gauze Pads | Gauze Pads
Aircast Sport Ankle Brace/Left | Aircast Sport Ankle Brace/Left
Naproxen Comfort Pac | Naproxen Comfort Pac
Daily Vitamins | Daily Vitamins
Itraconazole | Itraconazole
One Daily For Women | One Daily For Women
E-Z Spacer | E-Z Spacer
Oxymetazoline HCl | Oxymetazoline HCl
Acyclovir-Lidocaine HCl | Acyclovir-Lidocaine HCl
Mucinex Chest Congestion Child | Mucinex Chest Congestion Child
Stridex Clear Cycle Deep Wash | Stridex Clear Cycle Deep Wash
B-6 | B-6
Xopenex Concentrate | Xopenex Concentrate
Calcium Carbonate | Calcium Carbonate
CVS Vitamin D | CVS Vitamin D
BuPROPion HCl | BuPROPion HCl
CeraVe PM | CeraVe PM
Eucerin Plus Intensive Repair | Eucerin Plus Intensive Repair
Nasal Decongestant | Nasal Decongestant
HydrOXYzine Pamoate | HydrOXYzine Pamoate
Benefiber Drink Mix | Benefiber Drink Mix
Escitalopram Oxalate | Escitalopram Oxalate
Biotin 5000 | Biotin 5000
Valium | Valium
Flintstones Gummies Complete | Flintstones Gummies Complete
Onfi | Onfi
Azo-tabs | Azo-tabs
Neosporin | Neosporin
Tessalon | Tessalon
Tinactin Deodorant | Tinactin Deodorant
Tylenol/Codeine #3 | Tylenol/Codeine #3
Griseofulvin Micronized | Griseofulvin Micronized
Fever Reducer | Fever Reducer
Pseudophed-Chlophedianol-GG | Pseudophed-Chlophedianol-GG
Ethambutol HCl | Ethambutol HCl
Rifampin | Rifampin
B complex | B complex
Paper Tape | Paper Tape
Paper Tape 1"x12yd | Paper Tape 1"x12yd
Brotapp | Brotapp
Cane | Cane
Glucostrips | Glucostrips
Humalog KwikPen | Humalog KwikPen
Insulin Pen Needle | Insulin Pen Needle
Alcohol Swabs | Alcohol Swabs
Lantus SoloStar | Lantus SoloStar
TRUEtest Test | TRUEtest Test
Ipratropium Bromide HFA | Ipratropium Bromide HFA
Geri-Lanta | Geri-Lanta
BL Hydrocortisone Acetate | BL Hydrocortisone Acetate
FP Hydrocortisone | FP Hydrocortisone
A+D Prevent | A+D Prevent
Besifloxacin HCl | Besifloxacin HCl
Vit Calcium Citrate + D | Vit Calcium Citrate + D
Cortef | Cortef
DDAVP | DDAVP
ZyrTEC Allergy Childrens | ZyrTEC Allergy Childrens
Oxytetracycline | Oxytetracycline
Aveeno Daily Moisturizer | Aveeno Daily Moisturizer
Benefiber For Children | Benefiber For Children
Ducodyl | Ducodyl
Fleet Pediatric | Fleet Pediatric
Loperamide A-D | Loperamide A-D
Eye Drops | Eye Drops
Dimetapp Maximum Strength | Dimetapp Maximum Strength
Wart Off | Wart Off
Dextromethorphan-Benzocaine | Dextromethorphan-Benzocaine
Aquaphor Lip Repair | Aquaphor Lip Repair
Vitamin A &amp; D | Vitamin A &amp; D
Hydrophilic | Hydrophilic
Simvastatin | Simvastatin
Pravastatin Sodium | Pravastatin Sodium
Azithromycin Hydrogencitrate | Azithromycin Hydrogencitrate
Sunscreen SPF30 | Sunscreen SPF30
Ear Wax Removal Drops | Ear Wax Removal Drops
Peak Flow Meter | Peak Flow Meter
Multivitamin Gummies Adults | Multivitamin Gummies Adults
Ankle Brace/Flexible Stays Lg | Ankle Brace/Flexible Stays Lg
Sock Aid | Sock Aid
Amphetamine-Dextroamphetamine | Amphetamine-Dextroamphetamine
Polymyxin B Sulfate | Polymyxin B Sulfate
Triaminic Cold/Allergy Child | Triaminic Cold/Allergy Child
Childrens Multi Vits/Calcium | Childrens Multi Vits/Calcium
Multiple Vitamins-Iron | Multiple Vitamins-Iron
RID Complete Lice Elimination | RID Complete Lice Elimination
Pedialyte Freezer Pops | Pedialyte Freezer Pops
AmLactin | AmLactin
Adapalene-Clindamycin Phos | Adapalene-Clindamycin Phos
Acetaminophen Extra Strength | Acetaminophen Extra Strength
Calcium 500/D | Calcium 500/D
Calcium 500 +D | Calcium 500 +D
Nizatidine | Nizatidine
Benzoyl Peroxide-HC | Benzoyl Peroxide-HC
SM Childrens Loratidine | SM Childrens Loratidine
Erythromycin Ethylsuccinate | Erythromycin Ethylsuccinate
Sklice | Sklice
Neo-Synephrine | Neo-Synephrine
Pseudoeph-Chlorphen-DM | Pseudoeph-Chlorphen-DM
Crutch Set | Crutch Set
Carboxymethylcellulose Sodium | Carboxymethylcellulose Sodium
DM-Benzocaine-Menthol | DM-Benzocaine-Menthol
Protopic | Protopic
PrednisoLONE Acetate | PrednisoLONE Acetate
Dimetapp Long Act Cough/Cold | Dimetapp Long Act Cough/Cold
Kerydin | Kerydin
Ayr Saline Nasal Gel | Ayr Saline Nasal Gel
Robitussin Cough/Cold CF Max | Robitussin Cough/Cold CF Max
Robitussin Cough/Congestion | Robitussin Cough/Congestion
Cholest Off | Cholest Off
Prenaissance Plus | Prenaissance Plus
Flinstones Gummies Omega-3 DHA | Flinstones Gummies Omega-3 DHA
Cortizone-10 Eczema | Cortizone-10 Eczema
Neosporin Eczema Essentials | Neosporin Eczema Essentials
Iron Chews Pediatric | Iron Chews Pediatric
Normal Saline Nose drops | Normal Saline Nose drops
Ultravate | Ultravate
Junel FE 1/20 | Junel FE 1/20
Tylenol Allergy Multi-Symptom | Tylenol Allergy Multi-Symptom
Loratadine Hives Relief | Loratadine Hives Relief
AeroChamber Plus Flo-Vu | AeroChamber Plus Flo-Vu
Dimetapp Decongestant | Dimetapp Decongestant
Accu-Chek Compact Plus Care | Accu-Chek Compact Plus Care
Accu-Chek Compact Test Drum | Accu-Chek Compact Test Drum
FreeStyle Lancets | FreeStyle Lancets
FreeStyle Lite Test | FreeStyle Lite Test
Methylphenidate HCl ER (LA) | Methylphenidate HCl ER (LA)
Non-Adherent Pads | Non-Adherent Pads
Cough DM Childrens | Cough DM Childrens
Q-Tapp | Q-Tapp
Duac | Duac
Animal Chewable Multi Complete | Animal Chewable Multi Complete
Calcium 600+D High Potency | Calcium 600+D High Potency
Chlorhexidine-Isopropyl Alc | Chlorhexidine-Isopropyl Alc
Halobetasol Propionate | Halobetasol Propionate
Keralyt | Keralyt
Athletes Foot Spray | Athletes Foot Spray
Benzoic Acid | Benzoic Acid
Ampicillin | Ampicillin
Pari LC Plus Pediatric | Pari LC Plus Pediatric
Acetaminophen Childrens | Acetaminophen Childrens
Clarinex-D 12 Hour | Clarinex-D 12 Hour
Fluocinonide-E | Fluocinonide-E
Honey Lemon Cough Drops | Honey Lemon Cough Drops
Tinidazole | Tinidazole
Plaquenil | Plaquenil
Methotrexate (Anti-Rheumatic) | Methotrexate (Anti-Rheumatic)
Childrens Cough/Runny Nose | Childrens Cough/Runny Nose
Ankle Brace Adjust-to-Fit | Ankle Brace Adjust-to-Fit
Nasal Moisturizing Spray | Nasal Moisturizing Spray
bacitracin ointment | bacitracin ointment
Desonil Cream | Desonil Cream
Cold &amp; Cough DM | Cold &amp; Cough DM
Poly-Vitamin/Iron | Poly-Vitamin/Iron
Valproate Sodium | Valproate Sodium
Insulin Beef | Insulin Beef
Childrens Acetaminophen | Childrens Acetaminophen
Wart Remover Maximum Strength | Wart Remover Maximum Strength
Dicyclomine HCl | Dicyclomine HCl
Gel Heel Cushions Mens | Gel Heel Cushions Mens
Caladryl | Caladryl
Lactobacillus Rhamnosus (GG) | Lactobacillus Rhamnosus (GG)
EQL Vitamin D Gummies Child | EQL Vitamin D Gummies Child
Childrens Vitamins | Childrens Vitamins
Poly-Vitamins | Poly-Vitamins
Delsym Cgh/Cld Nighttime Child | Delsym Cgh/Cld Nighttime Child
Digital Fever Thermometer | Digital Fever Thermometer
Ayr Saline Nasal | Ayr Saline Nasal
Penicillin | Penicillin
Mineral Oil Light | Mineral Oil Light
Robitussin Ped Cough/Cold CF | Robitussin Ped Cough/Cold CF
MetroCream | MetroCream
Thermometer Standard Unit | Thermometer Standard Unit
CVS Ibuprofen | CVS Ibuprofen
Neomycin-Polymyxin-Dexameth | Neomycin-Polymyxin-Dexameth
Throat Spray | Throat Spray
Ocean Nasal Spray | Ocean Nasal Spray
Arnuity Ellipta | Arnuity Ellipta
Ambi Fade Normal Skin | Ambi Fade Normal Skin
Anbesol | Anbesol
Ear Syringe | Ear Syringe
Lactaid | Lactaid
Antacid Liquid | Antacid Liquid
Latex Gloves | Latex Gloves
BIPAP Machine | BIPAP Machine
Gammagard S/D | Gammagard S/D
Sinus Wash Saline Refills | Sinus Wash Saline Refills
Liner (Chucks) | Liner (Chucks)
One Daily Multivitamin/Iron | One Daily Multivitamin/Iron
12 Hour Nasal Spray | 12 Hour Nasal Spray
Atomoxetine HCl | Atomoxetine HCl
Tussin DM | Tussin DM
Mercaptopurine | Mercaptopurine
Poly-Vi-Sol | Poly-Vi-Sol
Beclomethasone Dipropionate | Beclomethasone Dipropionate
Guaifenesin AC | Guaifenesin AC
Bactericin | Bactericin
Systane | Systane
Neupogen | Neupogen
OXcarbazepine ER | OXcarbazepine ER
Oxtellar XR | Oxtellar XR
Ferrous Fumarate | Ferrous Fumarate
Propylene Glycol | Propylene Glycol
Robitussin Cough+ Chest Max St | Robitussin Cough+ Chest Max St
Carafate | Carafate
Prevacid 24HR | Prevacid 24HR
NoHist DMX | NoHist DMX
Benzac W Wash | Benzac W Wash
Heating Pad Moist/Dry | Heating Pad Moist/Dry
Moisturizing Creme | Moisturizing Creme
Zomacton | Zomacton
Growth hormone | Growth hormone
Pseudoephedrine HCl (Deter) | Pseudoephedrine HCl (Deter)
Leucovorin Calcium | Leucovorin Calcium
D-Vi-Sol | D-Vi-Sol
Blistex | Blistex
Cepacol Sore Throat Ex St | Cepacol Sore Throat Ex St
Calcium 500+D High Potency | Calcium 500+D High Potency
Ciprofloxacin-Dexamethasone | Ciprofloxacin-Dexamethasone
APAP-Codeine &amp; Diet Manage Pr | APAP-Codeine &amp; Diet Manage Pr
Losartan Potassium | Losartan Potassium
Nasal Spray Moisturizing 12 HR | Nasal Spray Moisturizing 12 HR
Lamisil AT Jock Itch | Lamisil AT Jock Itch
Acetaminophen Junior Strength | Acetaminophen Junior Strength
IBU | IBU
Triamcinolone &amp; Emollient | Triamcinolone &amp; Emollient
Witch Hazel | Witch Hazel
Day Time Cold/Flu Relief | Day Time Cold/Flu Relief
Night Time Cold/Flu Relief | Night Time Cold/Flu Relief
Baclofen | Baclofen
Knee Orthoses (Bilateral) | Knee Orthoses (Bilateral)
Zonegran | Zonegran
Zonisamide | Zonisamide
Penicillamine | Penicillamine
Tylenol Cold | Tylenol Cold
Prednicarbate | Prednicarbate
Petrolatum | Petrolatum
Cepacol Mouthwash/Gargle | Cepacol Mouthwash/Gargle
Afrin Saline Nasal Mist | Afrin Saline Nasal Mist
Metadate ER | Metadate ER
Carbamide Peroxide-Saline | Carbamide Peroxide-Saline
Aveeno Baby Cleansing Therapy | Aveeno Baby Cleansing Therapy
Calcium Citrate | Calcium Citrate
PediaCare Childrens Multi-Symp | PediaCare Childrens Multi-Symp
Wrist Brace | Wrist Brace
Mucinex Cold/Kids | Mucinex Cold/Kids
CVS Eye Patch | CVS Eye Patch
Neo-Synephrine 12 Hour Spray | Neo-Synephrine 12 Hour Spray
Callus Cushions | Callus Cushions
Corn/Callus Remover | Corn/Callus Remover
Refresh Plus | Refresh Plus
Clear Eyes All Seasons | Clear Eyes All Seasons
Clear Eyes Maximum Itchy Eye | Clear Eyes Maximum Itchy Eye
Little Noses Saline | Little Noses Saline
A+D First Aid | A+D First Aid
Maalox Plus | Maalox Plus
Tears Naturale Free | Tears Naturale Free
Gas-X With Maalox Ex St | Gas-X With Maalox Ex St
Multivitamin Gummies Mens | Multivitamin Gummies Mens
AeroChamber MAX w/Mask Small | AeroChamber MAX w/Mask Small
DML Forte | DML Forte
Cod Liver | Cod Liver
Lubriderm | Lubriderm
Chloraseptic Total | Chloraseptic Total
Childrens Loratadine | Childrens Loratadine
CPAP Machine | CPAP Machine
Fiber Therapy | Fiber Therapy
Anbesol Cold Sore Therapy | Anbesol Cold Sore Therapy
Compound W for Kids | Compound W for Kids
Salicylic Acid in Alcohol | Salicylic Acid in Alcohol
Mineral Ice | Mineral Ice
Gauze Sponge | Gauze Sponge
AeroChamber Plus w/Mask Large | AeroChamber Plus w/Mask Large
CVS Epsom Salt | CVS Epsom Salt
Dermatop | Dermatop
Acetaminophen Jr | Acetaminophen Jr
Patanase | Patanase
Head &amp; Shoulders Classic Clean | Head &amp; Shoulders Classic Clean
Veramyst | Veramyst
Codeine-Chlorpheniramine-APAP | Codeine-Chlorpheniramine-APAP
Humidifiers | Humidifiers
Metamucil Fiber Singles | Metamucil Fiber Singles
Oral Rinse | Oral Rinse
Robitussin CoughGels | Robitussin CoughGels
Imipramine HCl | Imipramine HCl
Oxybutynin Chloride | Oxybutynin Chloride
Ritalin | Ritalin
Dextroamphetamine Sulfate | Dextroamphetamine Sulfate
GuanFACINE HCl ER | GuanFACINE HCl ER
Tussin CF Cough &amp; Cold | Tussin CF Cough &amp; Cold
Dextroamphetamine Sulfate ER | Dextroamphetamine Sulfate ER
Vaporizers | Vaporizers
Eye Irrigating | Eye Irrigating
Phenylephrine-DM-GG-APAP | Phenylephrine-DM-GG-APAP
Lupron Depot-Ped | Lupron Depot-Ped
Lupron Depot | Lupron Depot
AeroChamber Mini Chamber | AeroChamber Mini Chamber
Culturelle | Culturelle
Advil Cold &amp; Sinus Liqui-Gels | Advil Cold &amp; Sinus Liqui-Gels
OptiChamber Advantage-Med Mask | OptiChamber Advantage-Med Mask
Fludrocortisone Acetate | Fludrocortisone Acetate
Syringe 2-3 ML | Syringe 2-3 ML
AYR Saline Nasal Rinse | AYR Saline Nasal Rinse
Florinef | Florinef
Air Cleaners | Air Cleaners
Pampers UnderJams Boys S/M | Pampers UnderJams Boys S/M
Rufinamide | Rufinamide
Banzel | Banzel
PediaSure SideKicks Clear | PediaSure SideKicks Clear
KetoCal | KetoCal
DimenhyDRINATE | DimenhyDRINATE
Hydrocortisone Butyrate | Hydrocortisone Butyrate
Throat Lozenges | Throat Lozenges
Petrolatum White | Petrolatum White
Poly Vitamin | Poly Vitamin
GuaiFENesin DAC | GuaiFENesin DAC
Poly-Vi-Flor | Poly-Vi-Flor
Multiple Vitamin Essential | Multiple Vitamin Essential
Pediatric Vitamins | Pediatric Vitamins
Verdeso | Verdeso
Nasohist | Nasohist
Sotalol HCl | Sotalol HCl
Sotalol HCl (AF) | Sotalol HCl (AF)
Sotalol HCl AF | Sotalol HCl AF
Zyrtec Childrens Hives Relief | Zyrtec Childrens Hives Relief
K-Phos | K-Phos
Sensipar | Sensipar
GlycoLax | GlycoLax
Childrens Advil | Childrens Advil
CeraVe Hydrating Cleanser | CeraVe Hydrating Cleanser
Tums Kids | Tums Kids
Sudafed PE Childrens | Sudafed PE Childrens
Cold/Cough Childrens | Cold/Cough Childrens
Probiotic Acidophilus Beads | Probiotic Acidophilus Beads
Nicotine Step 3 | Nicotine Step 3
Bio Glo | Bio Glo
Pre-Natal Formula | Pre-Natal Formula
Delsym Cough/Cold Daytime | Delsym Cough/Cold Daytime
Orajel Baby Tooth/Gum | Orajel Baby Tooth/Gum
Zeasorb-AF | Zeasorb-AF
Flintstones Sour Gummies | Flintstones Sour Gummies
Cough Relief | Cough Relief
Gauze Bandage 2" | Gauze Bandage 2"
Lactobacillus Acidophilus | Lactobacillus Acidophilus
Eucerin Plus | Eucerin Plus
Calcium-Vitamin D | Calcium-Vitamin D
Lessina-28 | Lessina-28
Hibiclens | Hibiclens
Delsym Cough Childrens | Delsym Cough Childrens
Bicillin L-A | Bicillin L-A
Lubricating Lotion | Lubricating Lotion
Florajen4Kids | Florajen4Kids
Aquaphor Advanced Therapy | Aquaphor Advanced Therapy
Dimetapp MultiSymptom Cold/Flu | Dimetapp MultiSymptom Cold/Flu
Ultravate X (Ointment) | Ultravate X (Ointment)
Ear Drops | Ear Drops
Baby Anbesol | Baby Anbesol
Dexbrompheniramine-Pseudoeph | Dexbrompheniramine-Pseudoeph
Vanicream | Vanicream
Vanicream Lip Protectant | Vanicream Lip Protectant
Maalox Junior Plus Antigas | Maalox Junior Plus Antigas
Mucinex Cold Cgh Throat Child | Mucinex Cold Cgh Throat Child
Zenchent | Zenchent
nasonex | nasonex
Aveeno Baby Bath Treatment | Aveeno Baby Bath Treatment
Coreg | Coreg
Furosemide | Furosemide
ACE Wrist Brace | ACE Wrist Brace
Hydrocortisone Acetate-Aloe | Hydrocortisone Acetate-Aloe
Peridex | Peridex
Metamucil Smooth Texture | Metamucil Smooth Texture
Sulfasalazine | Sulfasalazine
Pentasa | Pentasa
Arch Bandage | Arch Bandage
Gel Heel Cushions | Gel Heel Cushions
ZyrTEC Itchy Eye | ZyrTEC Itchy Eye
Prenatal Complete | Prenatal Complete
Clarinex Reditabs | Clarinex Reditabs
Cepacol Sensations Cooling | Cepacol Sensations Cooling
Cepacol Sensations Hydra | Cepacol Sensations Hydra
Ankle Brace/Flexible Stays Sm | Ankle Brace/Flexible Stays Sm
Cold Pack Reusable | Cold Pack Reusable
Synalar (Ointment) | Synalar (Ointment)
Finger Splint Small | Finger Splint Small
Promethazine HCl | Promethazine HCl
Acetaminophen-DM | Acetaminophen-DM
Robitussin Pediatric | Robitussin Pediatric
Amoxicillin ER | Amoxicillin ER
Thermometer Deluxe/Small Card | Thermometer Deluxe/Small Card
Ensure Complete Shake | Ensure Complete Shake
KLS Aller-Tec Childrens | KLS Aller-Tec Childrens
Levocetirizine Dihydrochloride | Levocetirizine Dihydrochloride
Lidocaine-Prilocaine | Lidocaine-Prilocaine
Neosporin Eczema Essent Max St | Neosporin Eczema Essent Max St
Aveeno Skin Relief | Aveeno Skin Relief
Drs Choice Corn/Callus Remover | Drs Choice Corn/Callus Remover
Childrens Probitic | Childrens Probitic
Aveeno Skin Strengthening Body | Aveeno Skin Strengthening Body
Levocarnitine | Levocarnitine
Dramamine | Dramamine
Methylin | Methylin
Guaiatussin AC | Guaiatussin AC
Childrens NyQuil Cold/Cough | Childrens NyQuil Cold/Cough
Penicillin G Sodium | Penicillin G Sodium
Aveeno Baby Daily Moisture | Aveeno Baby Daily Moisture
LaMICtal XR | LaMICtal XR
Cimetidine HCl | Cimetidine HCl
Vaseline Petrolatum Gauze | Vaseline Petrolatum Gauze
Chewable Iron | Chewable Iron
Ferretts Chewable Iron | Ferretts Chewable Iron
Slow Fe | Slow Fe
CVS Hydrocortisone Anti-Itch | CVS Hydrocortisone Anti-Itch
Miconazole-Zinc Oxide-Petrolat | Miconazole-Zinc Oxide-Petrolat
Wheelchair Cushion | Wheelchair Cushion
Wheelchair Invalid Ring | Wheelchair Invalid Ring
Reveal DNA Paternity Test | Reveal DNA Paternity Test
Sling &amp; Swathe Shldr Immobiliz | Sling &amp; Swathe Shldr Immobiliz
Childrens Mylanta | Childrens Mylanta
Flublok | Flublok
Baby Thermometer | Baby Thermometer
Oral Thermometer | Oral Thermometer
Lotrimin Ultra | Lotrimin Ultra
Pseudoephedrine-DM-GG | Pseudoephedrine-DM-GG
Polyethylene Glycol 3350-GRX | Polyethylene Glycol 3350-GRX
Ciprofloxacin | Ciprofloxacin
EMLA | EMLA
Norgestim-Eth Estrad Triphasic | Norgestim-Eth Estrad Triphasic
Viroptic | Viroptic
Norditropin FlexPro | Norditropin FlexPro
Hydrocortisone-Aloe Vera | Hydrocortisone-Aloe Vera
Vestura | Vestura
Fluocinolone Acetonide Scalp | Fluocinolone Acetonide Scalp
Hydroxyurea | Hydroxyurea
NovoLog Flexpen | NovoLog Flexpen
Pedialyte Advanced Care | Pedialyte Advanced Care
EpiPen Jr | EpiPen Jr
AeroChamber Plus Flo-Vu Small | AeroChamber Plus Flo-Vu Small
Natroba | Natroba
Capsaicin | Capsaicin
Valproic Acid | Valproic Acid
Vitamin B-Complex | Vitamin B-Complex
Riboflavin | Riboflavin
Benzocaine-Antipyrine | Benzocaine-Antipyrine
Enema Mineral Oil | Enema Mineral Oil
Eczema Moisturizing | Eczema Moisturizing
Desoximetasone | Desoximetasone
Childrens Motrin Cold | Childrens Motrin Cold
Fluoxetine HCl (PMDD) | Fluoxetine HCl (PMDD)
RID Essential Lice Elimination | RID Essential Lice Elimination
Triaminic | Triaminic
Dimaphen DM Cold/Cough Child | Dimaphen DM Cold/Cough Child
Multi-Vitamin Gummies | Multi-Vitamin Gummies
Multivitamins/Fluoride | Multivitamins/Fluoride
Aeroneb Go Nebulizer Handset | Aeroneb Go Nebulizer Handset
No Iron Mult Vitamin-Minerals | No Iron Mult Vitamin-Minerals
Womens Daily Formula | Womens Daily Formula
CVS Childrens Ibuprofen | CVS Childrens Ibuprofen
Cold &amp; Cough Childrens | Cold &amp; Cough Childrens
Masks | Masks
kenalog | kenalog
Vital-D Rx | Vital-D Rx
Diphenoxylate HCl | Diphenoxylate HCl
Dacriose | Dacriose
Soriatane | Soriatane
Azithromycin Dihydrate | Azithromycin Dihydrate
Alyacen 1/35 | Alyacen 1/35
Vitamin Liquid | Vitamin Liquid
Delsym Cough/Chest Congest DM | Delsym Cough/Chest Congest DM
Maalox Regular Strength | Maalox Regular Strength
Mederma For Kids | Mederma For Kids
Cepacol Antibacterial | Cepacol Antibacterial
Probiotic Formula | Probiotic Formula
Transpore Surgical 1"x1-1/2yd | Transpore Surgical 1"x1-1/2yd
Cod Liver Oil For Kids | Cod Liver Oil For Kids
Acetaminophen ER | Acetaminophen ER
Sinus Rinse Kit Pediatric | Sinus Rinse Kit Pediatric
Nebulizers | Nebulizers
Pill Box 7 Day | Pill Box 7 Day
Childrens Gummies | Childrens Gummies
Sterile Water for Irrigation | Sterile Water for Irrigation
Desonide Crea-Moisturizing Lot | Desonide Crea-Moisturizing Lot
Permethrin &amp; Pyreth-Pip But | Permethrin &amp; Pyreth-Pip But
Afrin Childrens | Afrin Childrens
Gas-X | Gas-X
Loestrin 1.5/30 (21) | Loestrin 1.5/30 (21)
Psyllium Husk | Psyllium Husk
KP Ketotifen Fumarate | KP Ketotifen Fumarate
Guaifen DM | Guaifen DM
Aspirin Childrens | Aspirin Childrens
Probiotic Daily | Probiotic Daily
Fiber (Guar Gum) | Fiber (Guar Gum)
Caltrate Gummy Bites | Caltrate Gummy Bites
Thiamine HCl | Thiamine HCl
Mycostatin | Mycostatin
Elastic Bandage 3" | Elastic Bandage 3"
Sudafed PE Cold &amp; Cough Child | Sudafed PE Cold &amp; Cough Child
Condoms - Male | Condoms - Male
A &amp; D | A &amp; D
Magic mouth wash | Magic mouth wash
Hot Packs | Hot Packs
Prenatal Plus DHA | Prenatal Plus DHA
Calcium 500+D | Calcium 500+D
SM Hydrocortisone | SM Hydrocortisone
Humidifier/Vaporizer Supplies | Humidifier/Vaporizer Supplies
Ayr Nasal Mist Allergy/Sinus | Ayr Nasal Mist Allergy/Sinus
Herbal Therapy | Herbal Therapy
Retinol | Retinol
Vitalets | Vitalets
Caladryl Clear | Caladryl Clear
PediaSure 1.5 Cal/Fiber | PediaSure 1.5 Cal/Fiber
Xolegel Duo/Head &amp; Shoulders | Xolegel Duo/Head &amp; Shoulders
Healthy Kids Vitamin D3 | Healthy Kids Vitamin D3
Diphenhydramine-Zinc Acetate | Diphenhydramine-Zinc Acetate
Aveeno Moisturizing | Aveeno Moisturizing
Probiotic Acidophilus | Probiotic Acidophilus
Childrens Motrin Jr Strength | Childrens Motrin Jr Strength
Dietary Fiber Laxative | Dietary Fiber Laxative
Glycerin (Infant) | Glycerin (Infant)
One Touch Glucose Control | One Touch Glucose Control
One Touch Test Strip Holder | One Touch Test Strip Holder
Cepacol Sensations Warming | Cepacol Sensations Warming
Vitamin B6 | Vitamin B6
Alavert | Alavert
Colace Pediatric | Colace Pediatric
Glycerin (Child) | Glycerin (Child)
Listerine Antiseptic | Listerine Antiseptic
Bacid | Bacid
Post-OP Shoe/Soft Top Men | Post-OP Shoe/Soft Top Men
Mucinex Cough For Kids | Mucinex Cough For Kids
Child Chewable Vitamins/Iron | Child Chewable Vitamins/Iron
Tensor Elastic Bandage | Tensor Elastic Bandage
Etodolac | Etodolac
Atropine Sulfate | Atropine Sulfate
Griseofulvin | Griseofulvin
Mucinex Childrens | Mucinex Childrens
Purinethol | Purinethol
Knee Support | Knee Support
OptiChamber Face Mask-Medium | OptiChamber Face Mask-Medium
Childrens Ibuprofen 100 | Childrens Ibuprofen 100
Mederma PM | Mederma PM
Magnesium Oxide | Magnesium Oxide
Kids Vitamins Complete | Kids Vitamins Complete
Face Mask Earloop-Style | Face Mask Earloop-Style
Humalog Pen | Humalog Pen
Acidophilus Probiotic Blend | Acidophilus Probiotic Blend
Vicks VapoRub | Vicks VapoRub
Vitamin E-400 | Vitamin E-400
Band-Aid | Band-Aid
Xolegel | Xolegel
Gris-PEG | Gris-PEG
Pediatric Aerosol Mask | Pediatric Aerosol Mask
Ritalin LA | Ritalin LA
Norgestimate-Ethinyl Estradiol | Norgestimate-Ethinyl Estradiol
TGT Saline Nasal Spray | TGT Saline Nasal Spray
EPINEPHrine HCl | EPINEPHrine HCl
BreatheRite Coll Spacer Child | BreatheRite Coll Spacer Child
Vicks Air Purifier/HEPA | Vicks Air Purifier/HEPA
L-Thyroxine Sodium | L-Thyroxine Sodium
CVS Permethrin | CVS Permethrin
Oscal 500/200 D-3 | Oscal 500/200 D-3
Alcohol Prep | Alcohol Prep
Aveeno Baby Eczema Therapy | Aveeno Baby Eczema Therapy
Calcium Carb-Cholecalciferol | Calcium Carb-Cholecalciferol
Pseudoephedrine-DM | Pseudoephedrine-DM
Baby Ayr Saline | Baby Ayr Saline
Mucinex Allergy | Mucinex Allergy
Pepto-Bismol To-Go | Pepto-Bismol To-Go
Iohexol | Iohexol
Vagisil | Vagisil
Dex4 Glucose | Dex4 Glucose
Phenylephrine-Chlorphen-DM | Phenylephrine-Chlorphen-DM
Glycerin (Adult) | Glycerin (Adult)
Bacitracin-Polymyxin B | Bacitracin-Polymyxin B
Refresh Tears | Refresh Tears
Normal Saline Flush | Normal Saline Flush
Sodium Chloride Flush | Sodium Chloride Flush
Alinia | Alinia
Pamelor | Pamelor
Daily Value Multivitamin | Daily Value Multivitamin
Valerian Root | Valerian Root
Baby Orajel | Baby Orajel
Triaminic AM Cough/Decongest | Triaminic AM Cough/Decongest
Mylicon Infants Gas Relief | Mylicon Infants Gas Relief
DermaPhor | DermaPhor
Polysporin | Polysporin
Selenium Sulf-Pyrithione-Urea | Selenium Sulf-Pyrithione-Urea
Lasix | Lasix
CellCept | CellCept
AeroChamber Plus w/Mask Small | AeroChamber Plus w/Mask Small
Nasal Mist | Nasal Mist
Sumadan Wash | Sumadan Wash
Plexion | Plexion
Saline Bacteriostatic | Saline Bacteriostatic
Compound W Freeze Off Plantar | Compound W Freeze Off Plantar
Digital Thermometer | Digital Thermometer
GoodNites Underwear Boys L/XL | GoodNites Underwear Boys L/XL
Visine-AC | Visine-AC
BD Thermometer Oral Sheaths | BD Thermometer Oral Sheaths
Vitamin C Gummie | Vitamin C Gummie
Fluocinolone Acetonide Body | Fluocinolone Acetonide Body
Aluminum Hydroxide Gel | Aluminum Hydroxide Gel
Amoxicill-Clarithro-Lansopraz | Amoxicill-Clarithro-Lansopraz
Hydrocortisone Plus | Hydrocortisone Plus
Lovaza | Lovaza
Tubing Connector | Tubing Connector
Broncho Saline | Broncho Saline
Multi-Day Vitamins | Multi-Day Vitamins
Q-Tapp DM | Q-Tapp DM
Colace Clear | Colace Clear
Enema | Enema
CVS Nasal Spray | CVS Nasal Spray
Childrens Sudafed | Childrens Sudafed
PX Saline Nasal Spray | PX Saline Nasal Spray
Vicks Formula 44M Multi-Sympt | Vicks Formula 44M Multi-Sympt
Capex | Capex
Childrens Animal Shapes | Childrens Animal Shapes
Oxycodone-Acetaminophen | Oxycodone-Acetaminophen
Ped Multivitamins-Fl-Iron | Ped Multivitamins-Fl-Iron
Rolaids | Rolaids
AccuNeb | AccuNeb
Aluminum &amp; Magnesium Hydroxide | Aluminum &amp; Magnesium Hydroxide
PrenaPlus | PrenaPlus
Mineral Oil-Hydrophil Petrolat | Mineral Oil-Hydrophil Petrolat
Childrens Multi Vitamins/Iron | Childrens Multi Vitamins/Iron
Aveeno Bath Moisturizing | Aveeno Bath Moisturizing
CVS Saline Nasal Spray | CVS Saline Nasal Spray
Bandages | Bandages
Acid Mantle | Acid Mantle
Lansinoh/Breastfeeding Mothers | Lansinoh/Breastfeeding Mothers
Quillivant XR | Quillivant XR
Spinosad | Spinosad
Triaminic Childrens Allergy | Triaminic Childrens Allergy
NyQuil D Cold/Flu | NyQuil D Cold/Flu
Clear Eyes Natural Tears | Clear Eyes Natural Tears
Acetic Acid | Acetic Acid
PediaCare Children | PediaCare Children
Clobex | Clobex
Mucinex Cold Childrens | Mucinex Cold Childrens
Benadryl Extra Strength | Benadryl Extra Strength
Benzocaine-Menthol | Benzocaine-Menthol
Triaminic Chest/Nasal Congest | Triaminic Chest/Nasal Congest
Benzoyl Peroxide Cleanser | Benzoyl Peroxide Cleanser
Benzocaine-Benzalk Cl-SD Alc | Benzocaine-Benzalk Cl-SD Alc
Amitiza | Amitiza
MCT Oil | MCT Oil
PediaSure Enteral/Fiber/FOS | PediaSure Enteral/Fiber/FOS
Norvasc | Norvasc
Denavir | Denavir
Pediatric Medium Mask | Pediatric Medium Mask
Dilantin | Dilantin
VitaMelts Vitamin D | VitaMelts Vitamin D
Vitalets Childrens | Vitalets Childrens
Bromtuss DM | Bromtuss DM
Dexmethylphenidate HCl | Dexmethylphenidate HCl
Ocella | Ocella
EQ Saline Nasal Spray | EQ Saline Nasal Spray
MethylPREDNISolone Acetate | MethylPREDNISolone Acetate
Mask Pediatric Size 3" | Mask Pediatric Size 3"
Diphenhydramine HCl-PE HCl Tan | Diphenhydramine HCl-PE HCl Tan
Compound W Maximum Strength | Compound W Maximum Strength
Methylphenidate | Methylphenidate
Chloroquine Phosphate | Chloroquine Phosphate
Nasal Moisturizer Combination | Nasal Moisturizer Combination
White Petrolatum-Mineral Oil | White Petrolatum-Mineral Oil
Dramamine for Kids | Dramamine for Kids
Vitamin K1 | Vitamin K1
Cetaphil Gentle Cleanser | Cetaphil Gentle Cleanser
Polyethylene Glycol 1450 | Polyethylene Glycol 1450
Night Time Cold Medicine | Night Time Cold Medicine
Caltrate 600+D Plus | Caltrate 600+D Plus
Typhoid Vaccine | Typhoid Vaccine
Chloral Hydrate | Chloral Hydrate
Eye Patches | Eye Patches
Bacitracin-Polymyx-Neo-HC | Bacitracin-Polymyx-Neo-HC
Nasal Spray Saline | Nasal Spray Saline
Cepacol Fizzlers | Cepacol Fizzlers
Pediatric Multivit-Minerals-C | Pediatric Multivit-Minerals-C
Afrin Sinus | Afrin Sinus
Talc-Zinc Oxide | Talc-Zinc Oxide
Feverall | Feverall
Glycerin (Infants &amp; Children) | Glycerin (Infants &amp; Children)
Kids Gummy Bear Vitamins | Kids Gummy Bear Vitamins
Acanya | Acanya
Tazarotene | Tazarotene
Fish Oil + D3 | Fish Oil + D3
Fer-Iron | Fer-Iron
Tetracaine HCl | Tetracaine HCl
TEGretol-XR | TEGretol-XR
Loratadine-D 12HR | Loratadine-D 12HR
Telfa Clear Dressing 39"x25yd | Telfa Clear Dressing 39"x25yd
Kelo-cote | Kelo-cote
Mylicon | Mylicon
Centrum Performance | Centrum Performance
Multivitamin Drops/Fluoride | Multivitamin Drops/Fluoride
Iron Combinations | Iron Combinations
Axid | Axid
Aluminum Acetate | Aluminum Acetate
Pyridostigmine Bromide | Pyridostigmine Bromide
OptiChamber Diamond | OptiChamber Diamond
Dimetapp Cold/Congestion | Dimetapp Cold/Congestion
Tylenol Infants | Tylenol Infants
Ankle Wrap | Ankle Wrap
Salmeterol Xinafoate | Salmeterol Xinafoate
Probiotic Pearls Childrens | Probiotic Pearls Childrens
Cozaar | Cozaar
Adhesive 1/2"x6yd | Adhesive 1/2"x6yd
Gauze Bandage 4" | Gauze Bandage 4"
Pimecrolimus | Pimecrolimus
Cloderm | Cloderm
Triaminic Cold/Cough | Triaminic Cold/Cough
Vitamax Pediatric | Vitamax Pediatric
AeroChamber Z-Stat Plus/Medium | AeroChamber Z-Stat Plus/Medium
Bisacodyl | Bisacodyl
Humulin N | Humulin N
Refresh | Refresh
Carex Coccyx Cushion | Carex Coccyx Cushion
Iron 100/C | Iron 100/C
Pediatric Multivitamins-Fl | Pediatric Multivitamins-Fl
Tylenol Childrens Cough | Tylenol Childrens Cough
Culturelle For Kids | Culturelle For Kids
Vusion | Vusion
Cyclessa | Cyclessa
Prednisolone Sod Phosphate | Prednisolone Sod Phosphate
Dramamine Less Drowsy | Dramamine Less Drowsy
Multiple Vitamin-Folic Acid | Multiple Vitamin-Folic Acid
Robitussin Cold+Flu Nighttime | Robitussin Cold+Flu Nighttime
Aveeno Eczema Therapy Care | Aveeno Eczema Therapy Care
Dextromethorphan Polistirex | Dextromethorphan Polistirex
Ensure Plus | Ensure Plus
Opticlude Eye Patch Regular | Opticlude Eye Patch Regular
Nystatin &amp; Diaper Rash Product | Nystatin &amp; Diaper Rash Product
Budesonide (Inhalation) | Budesonide (Inhalation)
Erygel | Erygel
Pampers Easy Ups Boys Size 4 | Pampers Easy Ups Boys Size 4
Band-Aid Butterfly Closure | Band-Aid Butterfly Closure
Kaopectate | Kaopectate
Cimetidine 200 | Cimetidine 200
Pyrethrins-Piperonyl Butoxide | Pyrethrins-Piperonyl Butoxide
Benadryl Itch Stopping | Benadryl Itch Stopping
Oxistat | Oxistat
Catapres-TTS-1 | Catapres-TTS-1
Suppository Base | Suppository Base
Amphetamine Sulfate | Amphetamine Sulfate
Ultrathon Insect Repellent | Ultrathon Insect Repellent
Mucinex Child Multi-Symptom | Mucinex Child Multi-Symptom
Boost Kid Essentials 1.5/Fiber | Boost Kid Essentials 1.5/Fiber
Pred Mild | Pred Mild
Vitamin B-2 | Vitamin B-2
Dulcolax Stool Softener | Dulcolax Stool Softener
Hytrin | Hytrin
Contac Day/Night Cold/Flu | Contac Day/Night Cold/Flu
Triaminic Multi-Symptom Fever | Triaminic Multi-Symptom Fever
Benztropine Mesylate | Benztropine Mesylate
Ear Wax Drops | Ear Wax Drops
Vaniply | Vaniply
DM-APAP-CPM | DM-APAP-CPM
Neomycin-Bacitracin Zn-Polymyx | Neomycin-Bacitracin Zn-Polymyx
Ear Thermometer | Ear Thermometer
Child APAP | Child APAP
Xylocaine | Xylocaine
Gummy Gel Base | Gummy Gel Base
PediaSure 1.0 Cal/Fiber | PediaSure 1.0 Cal/Fiber
Pediatric Multivit-Minerals | Pediatric Multivit-Minerals
Lidex | Lidex
Nasal Aspirator | Nasal Aspirator
Diphenhist | Diphenhist
Sunscreen SPF50 | Sunscreen SPF50
Brompheniramine-DM-PSE | Brompheniramine-DM-PSE
Iophen DM | Iophen DM
Benzocaine-Pectin | Benzocaine-Pectin
Tylenol Childrens Plus Cld/Cgh | Tylenol Childrens Plus Cld/Cgh
Advil PM | Advil PM
Breo Ellipta | Breo Ellipta
Cold Remedy | Cold Remedy
Dry Eyes | Dry Eyes
Brompheniramine-DM-GG | Brompheniramine-DM-GG
Poly-Vi-Flor/Iron | Poly-Vi-Flor/Iron
Phenylephrine-Guaifenesin | Phenylephrine-Guaifenesin
PediaCare Cough/Cold | PediaCare Cough/Cold
Amoxicillin Trihydrate | Amoxicillin Trihydrate
Guaifenesin-Codeine | Guaifenesin-Codeine
Brimonidine Tartrate | Brimonidine Tartrate
Brimonidine Tartrate-Timolol | Brimonidine Tartrate-Timolol
Alphagan P | Alphagan P
Pedia-Lax | Pedia-Lax
Infant APAP Drops | Infant APAP Drops
Pramoxine HCl | Pramoxine HCl
Pin-X | Pin-X
Preparation H Hydrocortisone | Preparation H Hydrocortisone
1-Methyl 2-Pyrrolidinone | 1-Methyl 2-Pyrrolidinone
Coumadin | Coumadin
Truvada | Truvada
Vasotec | Vasotec
Cefprozil | Cefprozil
Delsym Cgh/Chest Cong DM Child | Delsym Cgh/Chest Cong DM Child
Spenco Arch Support Insoles | Spenco Arch Support Insoles
Compression Stockings | Compression Stockings
Daytrana | Daytrana
Se-Natal 19 | Se-Natal 19
Multiple Vitamins/Iron | Multiple Vitamins/Iron
Bed Size Underpads | Bed Size Underpads
Disposable Gloves | Disposable Gloves
Latex Gloves Medium | Latex Gloves Medium
Alpha Lipoic Acid | Alpha Lipoic Acid
Sulfacetamide Sodium | Sulfacetamide Sodium
Ibuprofen Cold/Sinus | Ibuprofen Cold/Sinus
Evekeo | Evekeo
Vanicream Sunscreen | Vanicream Sunscreen
Vitamin Mixture | Vitamin Mixture
Dimaphen Childrens | Dimaphen Childrens
Vivotif Berna Vaccine | Vivotif Berna Vaccine
Zylet | Zylet
Duricef | Duricef
Caltrate Plus | Caltrate Plus
Align | Align
Medicated Wart Removers | Medicated Wart Removers
Tri Vi SOl | Tri Vi SOl
Neutrogena T/Gel | Neutrogena T/Gel
Delsym Night Cgh/Cold Children | Delsym Night Cgh/Cold Children
Arnica | Arnica
Arnicare | Arnicare
Pramoxine-Calamine | Pramoxine-Calamine
cream | cream
Kling Flexible Gauze | Kling Flexible Gauze
Xeroform Petrolatum Dressing | Xeroform Petrolatum Dressing
Little Colds Cough Formula | Little Colds Cough Formula
Levetiracetam | Levetiracetam
AeroChamber w/FLOWSIGnal | AeroChamber w/FLOWSIGnal
EpiCeram | EpiCeram
Pseudo | Pseudo
Blood Pressure | Blood Pressure
Digital Blood Pressure Kit | Digital Blood Pressure Kit
AeroChamber Z-Stat Plus | AeroChamber Z-Stat Plus
Cheratussin AC | Cheratussin AC
Siltussin DM DAS | Siltussin DM DAS
Lanolin | Lanolin
Lotrel | Lotrel
Betamethasone | Betamethasone
Chapstick | Chapstick
Scar Gel | Scar Gel
Scar Treatment | Scar Treatment
Mefenamic Acid | Mefenamic Acid
Vita Drops/Iron | Vita Drops/Iron
Triamcinolone Acetonide(Nasal) | Triamcinolone Acetonide(Nasal)
Salactic Film | Salactic Film
Pyrazinamide | Pyrazinamide
Tylenol Cold Multi-Symptom | Tylenol Cold Multi-Symptom
Nitazoxanide | Nitazoxanide
Aquacel Ag Foam | Aquacel Ag Foam
Benadryl Itch Relief Stick | Benadryl Itch Relief Stick
Cough/Head Congestion Relief D | Cough/Head Congestion Relief D
Naltrexone HCl | Naltrexone HCl
MethylPREDNISolone | MethylPREDNISolone
Robitussin DM Infant Drops | Robitussin DM Infant Drops
Medrol | Medrol
Influenza Virus Vac Live Quad | Influenza Virus Vac Live Quad
Influenza Virus Vaccine Live | Influenza Virus Vaccine Live
Influenza Virus Vaccine Split | Influenza Virus Vaccine Split
Vaporizing Steam | Vaporizing Steam
Persantine | Persantine
Xalatan | Xalatan
Hydrolatum | Hydrolatum
Cough DM | Cough DM
AeroChamber Plus Flo-Vu Medium | AeroChamber Plus Flo-Vu Medium
ChlorproMAZINE HCl | ChlorproMAZINE HCl
Rynex PSE | Rynex PSE
Lactose Intolerance | Lactose Intolerance
Hydrocortisone-Acetic Acid | Hydrocortisone-Acetic Acid
Ankle Brace/Flexible Stays XL | Ankle Brace/Flexible Stays XL
Mineral Oil Heavy | Mineral Oil Heavy
Alimentum | Alimentum
Murine Ear Wax Removal System | Murine Ear Wax Removal System
Eye Drops Maximum Relief | Eye Drops Maximum Relief
Eye Itch Relief | Eye Itch Relief
E-Z Spacer/Mask | E-Z Spacer/Mask
Fluorometholone Acetate | Fluorometholone Acetate
B &amp; L Sensitive Eyes Saline | B &amp; L Sensitive Eyes Saline
KP Terbinafine Hydrochloride | KP Terbinafine Hydrochloride
Zafirlukast | Zafirlukast
Polyvits/Fluoride/Iron | Polyvits/Fluoride/Iron
Praziquantel | Praziquantel
OptiChamber Face Mask-Large | OptiChamber Face Mask-Large
Camrese | Camrese
DayQuil/NyQuil Cold/Flu Relief | DayQuil/NyQuil Cold/Flu Relief
No Doz Maximum Strength | No Doz Maximum Strength
Boost Kids Essentials | Boost Kids Essentials
Feeding Supplies | Feeding Supplies
Feeding Tubes - Bags | Feeding Tubes - Bags
Suction Oral Swab System | Suction Oral Swab System
Tracheostomy Care | Tracheostomy Care
Vitamin K (Phytonadione) | Vitamin K (Phytonadione)
Atovaquone-Proguanil HCl | Atovaquone-Proguanil HCl
Dextromethorphan | Dextromethorphan
Miconazole | Miconazole
Nasal Spray Bottle | Nasal Spray Bottle
Pedialyte Singles | Pedialyte Singles
none | none
Erythromycin-Sulfisoxazole | Erythromycin-Sulfisoxazole
Glycerin | Glycerin
Mouthwashes | Mouthwashes
Acidophilus Lactobacillus | Acidophilus Lactobacillus
Carbamoxide Ear Drops | Carbamoxide Ear Drops
Cetirizine HCl Hives Relief | Cetirizine HCl Hives Relief
Ketoconazole &amp; Pyrithione Zinc | Ketoconazole &amp; Pyrithione Zinc
Vita-C | Vita-C
Dexmethylphenidate HCl ER | Dexmethylphenidate HCl ER
Lice B Gone | Lice B Gone
CVS Glycerin Child | CVS Glycerin Child
Phenylephrine-DM-GG | Phenylephrine-DM-GG
Poly-Vitamin | Poly-Vitamin
Pamper | Pamper
Nit Remover | Nit Remover
Infants Acetaminophen | Infants Acetaminophen
Please evaluate pt for | Please evaluate pt for
Steam Inhalers | Steam Inhalers
Aveeno Skin Relief Bath | Aveeno Skin Relief Bath
Azopt | Azopt
Digital Ear Thermometer | Digital Ear Thermometer
Cefuroxime Sodium | Cefuroxime Sodium
Midol Complete | Midol Complete
aerochamber with face mask | aerochamber with face mask
Zicam Cold Remedy | Zicam Cold Remedy
Ditropan | Ditropan
Polyethylene | Polyethylene
Santyl | Santyl
Medihoney Wound/Burn Dressing | Medihoney Wound/Burn Dressing
Catheter | Catheter
Hemorrhoid Donut | Hemorrhoid Donut
Scopolamine Base | Scopolamine Base
Cold Pak | Cold Pak
Mucinex Congest &amp; Cough Child | Mucinex Congest &amp; Cough Child
Cepacol Sore Throat + Cough | Cepacol Sore Throat + Cough
Pediatric Multi Vit-Extra C-FA | Pediatric Multi Vit-Extra C-FA
Lice Treatment Max St | Lice Treatment Max St
Aspirin-Acetaminophen-Caffeine | Aspirin-Acetaminophen-Caffeine
Mouthwash | Mouthwash
Asmanex 7 Metered Doses | Asmanex 7 Metered Doses
Atrovent HFA | Atrovent HFA
Asmanex Twisthaler | Asmanex Twisthaler
Levalbuterol Tartrate | Levalbuterol Tartrate
Aloe Vera | Aloe Vera
Aspir-81 | Aspir-81
Iodine | Iodine
Oxybutynin | Oxybutynin
Tegaderm + Pad 3-1/2"x4-1/8" | Tegaderm + Pad 3-1/2"x4-1/8"
Aveeno Advanced Care | Aveeno Advanced Care
OraMagic Plus | OraMagic Plus
OraMagicRx | OraMagicRx
Antihemophilic Factor (Recomb) | Antihemophilic Factor (Recomb)
Humatrope | Humatrope
Zinc | Zinc
Allergy | Allergy
Maalox Anti-Gas | Maalox Anti-Gas
Evaporative Humidifier | Evaporative Humidifier
Aveeno Soothing Bath Treatment | Aveeno Soothing Bath Treatment
Mucinex Stuffy Nose/Cold Child | Mucinex Stuffy Nose/Cold Child
Sensodyne Iso-Active Whitening | Sensodyne Iso-Active Whitening
Cold/Flu Relief | Cold/Flu Relief
Nutramigen | Nutramigen
Infants Simethicone | Infants Simethicone
PediaCare Childrens Nightrest | PediaCare Childrens Nightrest
Halls Cough Drops | Halls Cough Drops
Moisturizing Lotion | Moisturizing Lotion
CeraVe Baby | CeraVe Baby
No-Sting Skin-Prep | No-Sting Skin-Prep
Orapred ODT | Orapred ODT
Medicine Dropper | Medicine Dropper
Tylenol Arthritis Pain | Tylenol Arthritis Pain
Fluticasone Propionate (Inhal) | Fluticasone Propionate (Inhal)
Feosol Elixir | Feosol Elixir
Acetic Acid-Aluminum Acetate | Acetic Acid-Aluminum Acetate
Baby Orajel Tooth/Gum Cleanser | Baby Orajel Tooth/Gum Cleanser
Multi vitamins | Multi vitamins
ACE Bandage Self-Adhering | ACE Bandage Self-Adhering
Pyrantel Pamoate | Pyrantel Pamoate
Iron Supplement Childrens | Iron Supplement Childrens
Propylthiouracil | Propylthiouracil
Flintstones/My First | Flintstones/My First
Potassium Hydroxide | Potassium Hydroxide
Syringe | Syringe
Syringe (Disposable) | Syringe (Disposable)
Syringe 5-6 ML | Syringe 5-6 ML
Boudreauxs Butt Paste | Boudreauxs Butt Paste
HM Saline Nasal Spray | HM Saline Nasal Spray
Clear Eyes Seasonal Relief | Clear Eyes Seasonal Relief
Inderal | Inderal
Asmanex HFA | Asmanex HFA
Childrens Multivitamins/Iron | Childrens Multivitamins/Iron
Diclegis | Diclegis
HM Nasal Spray | HM Nasal Spray
Fluticasone-Salmeterol | Fluticasone-Salmeterol
Bandages Fabric Strips 3/4" | Bandages Fabric Strips 3/4"
Alcohol Preps | Alcohol Preps
Alum Hydroxide-Mag Carbonate | Alum Hydroxide-Mag Carbonate
Lozenges | Lozenges
Cetaphil Daily Advance | Cetaphil Daily Advance
Cantharidin | Cantharidin
Cast Shoe Pediatric | Cast Shoe Pediatric
Fluor-a-day | Fluor-a-day
Urea Nail | Urea Nail
Methylphenidate HCl ER (XR) | Methylphenidate HCl ER (XR)
Tiger Balm Pain Relieving | Tiger Balm Pain Relieving
Tiger Balm Regular Strength | Tiger Balm Regular Strength
Oralone | Oralone
Cold &amp; Cough Daytime | Cold &amp; Cough Daytime
Allegra-D Allergy &amp; Congestion | Allegra-D Allergy &amp; Congestion
Pediatric Mouthpiece | Pediatric Mouthpiece
Herpecin-L | Herpecin-L
Pronto Complete Lice Killing | Pronto Complete Lice Killing
Synagis | Synagis
Pedia Care Multi-Symptom Cold | Pedia Care Multi-Symptom Cold
Zyrtec Hives Relief | Zyrtec Hives Relief
Chloraseptic Kids | Chloraseptic Kids
Opticlude Eye Patch Junior | Opticlude Eye Patch Junior
Pill Splitter | Pill Splitter
Tri-Vi-Sol/Iron | Tri-Vi-Sol/Iron
Prenate DHA | Prenate DHA
Eye Drops Allergy Relief | Eye Drops Allergy Relief
Saline Wound Wash | Saline Wound Wash
Alive Multi-Vitamin Childrens | Alive Multi-Vitamin Childrens
AquADEKs | AquADEKs
Septra DS | Septra DS
Complete Prenatal | Complete Prenatal
Poly-Vitamin/Fluoride/Iron | Poly-Vitamin/Fluoride/Iron
Pari ProNeb Ultra II | Pari ProNeb Ultra II
Levemir FlexTouch | Levemir FlexTouch
Acthar HP | Acthar HP
KetoCal 4:1 | KetoCal 4:1
Topamax Sprinkle | Topamax Sprinkle
Infants Ibuprofen | Infants Ibuprofen
Monistat 1 | Monistat 1
Accu-Chek Nano SmartView | Accu-Chek Nano SmartView
Alcohol Pads | Alcohol Pads
Blood Glucose Test Strip | Blood Glucose Test Strip
OneTouch Lancets | OneTouch Lancets
OneTouch Ultra 2 | OneTouch Ultra 2
Urine Glucose-Ketones Test | Urine Glucose-Ketones Test
Bayer Contour next Link | Bayer Contour next Link
Bayer Contour Next Test | Bayer Contour Next Test
Povidone-Iodine | Povidone-Iodine
Redness Relief | Redness Relief
Rogaine Womens | Rogaine Womens
Triple Omega Complex | Triple Omega Complex
Sudafed Childrens Cold/Cough | Sudafed Childrens Cold/Cough
Nabumetone | Nabumetone
Gripp-Heel | Gripp-Heel
Wrist Splint | Wrist Splint
GNP Vitamin D | GNP Vitamin D
Mask Pediatric Size 1" | Mask Pediatric Size 1"
Ascorbic Acid | Ascorbic Acid
Clindamycin Phosphate in D5W | Clindamycin Phosphate in D5W
CVS Childrens Multivit/Extra C | CVS Childrens Multivit/Extra C
Florastor | Florastor
Benadryl Dye-Free Allergy | Benadryl Dye-Free Allergy
Vicks Vapo Therapy Steam Inhal | Vicks Vapo Therapy Steam Inhal
Thum | Thum
Cold Packs | Cold Packs
Antipyrine-Benzocaine-Polycos | Antipyrine-Benzocaine-Polycos
BD Insulin Syringe Half-Unit | BD Insulin Syringe Half-Unit
Embrace Blood Glucose Test | Embrace Blood Glucose Test
Embrace Lancets Ultra Thin 30G | Embrace Lancets Ultra Thin 30G
Embrace Pro Glucose Meter | Embrace Pro Glucose Meter
True Track Blood Glucose | True Track Blood Glucose
Ultra Thin Lancets | Ultra Thin Lancets
FreeStyle Test | FreeStyle Test
RA Saline Solution | RA Saline Solution
Diaper Rash | Diaper Rash
B Complex | B Complex
Homeopathic Products | Homeopathic Products
Cold/Allergy Childrens | Cold/Allergy Childrens
Nasal Aspirator Infant #311 | Nasal Aspirator Infant #311
Pulmicort Turbuhaler | Pulmicort Turbuhaler
Cold/Allergy | Cold/Allergy
Neocate Infant Formula | Neocate Infant Formula
Systane Balance | Systane Balance
HydrALAZINE HCl | HydrALAZINE HCl
ZITHROMAX | ZITHROMAX
Lip Balm Medicated | Lip Balm Medicated
Ichthammol | Ichthammol
Risperdal M-TAB | Risperdal M-TAB
Orabase | Orabase
Glycerin (Laxative) | Glycerin (Laxative)
Bromphenir Mal-PE HCl Tannate | Bromphenir Mal-PE HCl Tannate
Xeroform Petrolat Patch 4"x4" | Xeroform Petrolat Patch 4"x4"
SB Polyethylene Glycol 3350 | SB Polyethylene Glycol 3350
Benzyl Alcohol | Benzyl Alcohol
LiceMD | LiceMD
RA Sterile Eye Wash | RA Sterile Eye Wash
Thyroid | Thyroid
Depakote Sprinkles | Depakote Sprinkles
B Complex-Biotin-FA | B Complex-Biotin-FA
Coenzyme Q10 | Coenzyme Q10
Orthopedic shoes | Orthopedic shoes
DSS | DSS
Albumin Human | Albumin Human
Captopril | Captopril
Indocin | Indocin
ACE Ankle Brace | ACE Ankle Brace
Mucinex DM Maximum Strength | Mucinex DM Maximum Strength
4-Way Saline | 4-Way Saline
Polyvitamin/Fluoride | Polyvitamin/Fluoride
Oral Anesthetic | Oral Anesthetic
Vitamin D3 Complete | Vitamin D3 Complete
Desitin Maximum Strength | Desitin Maximum Strength
Dimetapp Cold/Fever | Dimetapp Cold/Fever
Neocate Infant | Neocate Infant
Cough &amp; Sore Throat NightTime | Cough &amp; Sore Throat NightTime
Bromphen Tan-Pseudoephed Tan | Bromphen Tan-Pseudoephed Tan
Balmex Skin Protectant | Balmex Skin Protectant
Proctosol HC | Proctosol HC
OptiChamber Face Mask-Small | OptiChamber Face Mask-Small
Little Remedies for Colds | Little Remedies for Colds
Procardia XL | Procardia XL
Digital BP Monitor Cuff | Digital BP Monitor Cuff
Nizoral A-D | Nizoral A-D
Tylenol Childrens Plus Cld/Alg | Tylenol Childrens Plus Cld/Alg
Brompheniramine Maleate | Brompheniramine Maleate
Millipred | Millipred
Occupational Wrist Supprt/L Lg | Occupational Wrist Supprt/L Lg
Thermo Knee Comforter | Thermo Knee Comforter
D3 Kids | D3 Kids
Hydrocortisone Ace-Pramoxine | Hydrocortisone Ace-Pramoxine
Carboxymethylcellul-Glycerin | Carboxymethylcellul-Glycerin
Vitamin B 12 | Vitamin B 12
DHA | DHA
Allegra-D 24 Hour | Allegra-D 24 Hour
Anti-Fungal | Anti-Fungal
Pediatric Multiple Vit-Vit C | Pediatric Multiple Vit-Vit C
EQ Nasal Spray | EQ Nasal Spray
Robitussin Mucus+Chest Congest | Robitussin Mucus+Chest Congest
Pseudoephedrine-Guaifenesin | Pseudoephedrine-Guaifenesin
Desitin Rapid Relief | Desitin Rapid Relief
Fer-Gen-Sol | Fer-Gen-Sol
Brompheniramine-PSE-APAP | Brompheniramine-PSE-APAP
TH Children Multi Vitamins | TH Children Multi Vitamins
Cetaphil RestoraDerm | Cetaphil RestoraDerm
Calcium Antacid | Calcium Antacid
Cervical Pillow | Cervical Pillow
Trimethobenzamide HCl | Trimethobenzamide HCl
Cervical Pillow/Cover | Cervical Pillow/Cover
Orthotics with Metatarsal Pad | Orthotics with Metatarsal Pad
Triaminic Cold/Cough Day Time | Triaminic Cold/Cough Day Time
Cleocin Phosphate | Cleocin Phosphate
Animi-3/Vitamin D | Animi-3/Vitamin D
Pediapred | Pediapred
Sodium Chloride (Diagnostic) | Sodium Chloride (Diagnostic)
Culturelle Digestive Health | Culturelle Digestive Health
PEG 3350 | PEG 3350
Desmopressin Ace Spray Refrig | Desmopressin Ace Spray Refrig
Desmopressin Acetate Spray | Desmopressin Acetate Spray
Sennosides-Docusate Sodium | Sennosides-Docusate Sodium
Cool Mist Humidifier 1.2 gal | Cool Mist Humidifier 1.2 gal
Blood Pressure Cuff | Blood Pressure Cuff
Senna-GRX | Senna-GRX
Mouthwash/Gargle | Mouthwash/Gargle
Vimpat | Vimpat
Ditropan XL | Ditropan XL
Levemir Flexpen | Levemir Flexpen
Day Time | Day Time
Docusate Calcium | Docusate Calcium
Benzocaine Oral Anesthetic | Benzocaine Oral Anesthetic
Benadryl Allergy/Sinus | Benadryl Allergy/Sinus
Motrin PM | Motrin PM
PolyVitamin/Fluoride | PolyVitamin/Fluoride
Hair/Skin/Nails | Hair/Skin/Nails
Duocal | Duocal
PediaSure 1.5 Cal | PediaSure 1.5 Cal
Monistat 3 Triple Action | Monistat 3 Triple Action
Flaxseed Oil | Flaxseed Oil
Menthol-Methyl Salicylate | Menthol-Methyl Salicylate
Enfamil AR LIPIL | Enfamil AR LIPIL
Dovonex | Dovonex
Multi Vita-Bets/Fluoride/Iron | Multi Vita-Bets/Fluoride/Iron
Benazepril HCl | Benazepril HCl
Desloratadine | Desloratadine
Gold Bond | Gold Bond
Sodium Phosphates | Sodium Phosphates
Nutramigen Toddler/Enflora LGG | Nutramigen Toddler/Enflora LGG
AeroChamber Plus Flo-Vu w/Mask | AeroChamber Plus Flo-Vu w/Mask
Hot/Cold Compress | Hot/Cold Compress
Eye Patch | Eye Patch
Visine Totality Multi-Symptom | Visine Totality Multi-Symptom
Erythromycin Estolate | Erythromycin Estolate
L-Carnitine | L-Carnitine
Maxalt-MLT | Maxalt-MLT
KLS Natural Psyllium Fiber | KLS Natural Psyllium Fiber
Enfamil Nutramigen LIPIL | Enfamil Nutramigen LIPIL
Allergy Medication Childrens | Allergy Medication Childrens
Allergy Medicine | Allergy Medicine
Cetaphil DermaControl Foam Wsh | Cetaphil DermaControl Foam Wsh
A+D Diaper Rash | A+D Diaper Rash
Aveeno Baby Calming Comfort | Aveeno Baby Calming Comfort
Peak Flow Meter-Inh Assist Dev | Peak Flow Meter-Inh Assist Dev
CVS Gummy Multivitamin Kids | CVS Gummy Multivitamin Kids
Paroxetine HCl | Paroxetine HCl
EryPed 400 | EryPed 400
EryPed 200 | EryPed 200
AF-Ibuprofen Infant | AF-Ibuprofen Infant
Vitamin C Plus | Vitamin C Plus
Alclometasone Dipropionate | Alclometasone Dipropionate
EQL Children Multivitamin/Iron | EQL Children Multivitamin/Iron
Cal-Gest Antacid | Cal-Gest Antacid
Vitamins A &amp; D | Vitamins A &amp; D
Ferro-Bob | Ferro-Bob
Hearing Aid | Hearing Aid
Budesonide-Formoterol Fumarate | Budesonide-Formoterol Fumarate
Vicks BabyRub | Vicks BabyRub
RA Saline Nasal Spray | RA Saline Nasal Spray
CVS Loratadine | CVS Loratadine
Centrum Jr/Extra Calcium | Centrum Jr/Extra Calcium
Oxiconazole Nitrate | Oxiconazole Nitrate
NasaDrops Saline on the Go | NasaDrops Saline on the Go
Hydrocortisone Max St | Hydrocortisone Max St
Pari LC Sprint Nebulizer Set | Pari LC Sprint Nebulizer Set
Kendall Sodium Chloride Flush | Kendall Sodium Chloride Flush
A + D Personal Care Lotion | A + D Personal Care Lotion
Norethin Ace-Eth Estrad-FE | Norethin Ace-Eth Estrad-FE
Allergy Medication | Allergy Medication
Band-Aid Gauze Large | Band-Aid Gauze Large
Siltussin DAS | Siltussin DAS
FeroSul | FeroSul
Alum &amp; Mag Hydroxide-Simeth | Alum &amp; Mag Hydroxide-Simeth
Mineral Oil-Oleth-Polysorbate | Mineral Oil-Oleth-Polysorbate
Neo-Polycin | Neo-Polycin
Sennosides | Sennosides
Ilotycin | Ilotycin
Vitamin C Drops | Vitamin C Drops
Pseudo Cough | Pseudo Cough
Cough/Cold Medicine | Cough/Cold Medicine
Maxalt | Maxalt
Rectal Thermometer | Rectal Thermometer
Triple Paste | Triple Paste
Orajel Mouth-Aid | Orajel Mouth-Aid
Vicks Vaporub | Vicks Vaporub
Needles | Needles
Levora 0.15/30 (28) | Levora 0.15/30 (28)
Hylatopic Plus | Hylatopic Plus
Romycin | Romycin
Corn Starch | Corn Starch
FluMist | FluMist
Neomycin-Polymyxin-Bacitracin | Neomycin-Polymyxin-Bacitracin
Flintstones Toddler | Flintstones Toddler
Betaine | Betaine
Carnitine | Carnitine
Hydroxocobalamin | Hydroxocobalamin
Propimex-1 | Propimex-1
Neomycin-Bacitracin-Polymyxin | Neomycin-Bacitracin-Polymyxin
Aluminum Chloride | Aluminum Chloride
Cortizone-10 Hydratensive | Cortizone-10 Hydratensive
Claravis | Claravis
Cotton Swabs | Cotton Swabs
Infants Mapap | Infants Mapap
Multi-Vit/Fluoride | Multi-Vit/Fluoride
Diethyl Toluamide | Diethyl Toluamide
Q-Dryl | Q-Dryl
Aveeno Active Nat Eczema Bath | Aveeno Active Nat Eczema Bath
Levoxyl | Levoxyl
Penicillin G Procaine | Penicillin G Procaine
Little Tummys Fiber Gummies | Little Tummys Fiber Gummies
DHA Omega 3 | DHA Omega 3
Omnitrope | Omnitrope
Pseudoephedrine HCl ER | Pseudoephedrine HCl ER
Glucometer (generic) | Glucometer (generic)
Lancets | Lancets
SB Glycerin Pediatric | SB Glycerin Pediatric
Cytotec | Cytotec
Vaporizer Refill | Vaporizer Refill
Aspirin-Caffeine | Aspirin-Caffeine
Kristalose | Kristalose
Motrin Cold &amp; Sinus | Motrin Cold &amp; Sinus
Depend Underwear Sm/Med | Depend Underwear Sm/Med
Talc-Starch | Talc-Starch
Garlic Oil | Garlic Oil
Ayr Saline Nasal No-Drip | Ayr Saline Nasal No-Drip
Animal Chewable Multiple Vit | Animal Chewable Multiple Vit
Mometasone Furo-Formoterol Fum | Mometasone Furo-Formoterol Fum
FeverAll Childrens | FeverAll Childrens
ProCentra | ProCentra
Enfamil Gentlease LIPIL | Enfamil Gentlease LIPIL
Fluocinolone Oint &amp; Emollient | Fluocinolone Oint &amp; Emollient
Coconut Oil | Coconut Oil
Thick-It | Thick-It
Neocate Junior | Neocate Junior
Blistex Medicated | Blistex Medicated
GNP Hydrocortisone | GNP Hydrocortisone
Chromium Picolinate | Chromium Picolinate
Tretinoin Microsphere Pump | Tretinoin Microsphere Pump
Suppository Mold Pediatric | Suppository Mold Pediatric
Thermometer Covers | Thermometer Covers
Similac | Similac
Methylcellulose | Methylcellulose
Imitrex | Imitrex
Eye Lubricant | Eye Lubricant
Childrens Allergy | Childrens Allergy
Childrens Allergy Medicine | Childrens Allergy Medicine
Visine Extra | Visine Extra
Baby Powder | Baby Powder
Neosure Advance | Neosure Advance
Pampers Baby Dry Size 6 | Pampers Baby Dry Size 6
All Clear Eye Drops | All Clear Eye Drops
Clear Eyes Redness Relief | Clear Eyes Redness Relief
Selsun Blue Daily | Selsun Blue Daily
Linezolid | Linezolid
OcuSoft Baby Eyelid &amp; Eyelash | OcuSoft Baby Eyelid &amp; Eyelash
Cordran | Cordran
Norethindrone Acetate | Norethindrone Acetate
Maca | Maca
Enfamil Nutramigen AA Lipil | Enfamil Nutramigen AA Lipil
Probiotic Product | Probiotic Product
Siladryl Allergy | Siladryl Allergy
Haloperidol | Haloperidol
Maalox Multi Symptom Max St | Maalox Multi Symptom Max St
Penicillin G Benzathine &amp; Proc | Penicillin G Benzathine &amp; Proc
Lactase | Lactase
Clonidine-Chlorthalidone | Clonidine-Chlorthalidone
Similac Neosure | Similac Neosure
Pari Mask Set | Pari Mask Set
DuoNeb | DuoNeb
ZzzQuil | ZzzQuil
Benzac AC Wash | Benzac AC Wash
Animal Shapes Plus Iron | Animal Shapes Plus Iron
Colloidal Oatmeal | Colloidal Oatmeal
Magnesium Citrate | Magnesium Citrate
Pediatric Cough/Cold | Pediatric Cough/Cold
Hydrophor | Hydrophor
Fiber 7 | Fiber 7
Estrace | Estrace
Lidocaine-Bacitracin | Lidocaine-Bacitracin
Emollient | Emollient
Lotion Base | Lotion Base
Ear Wax Removal Kit | Ear Wax Removal Kit
Eucerin Calming Daily Moist | Eucerin Calming Daily Moist
Lice Insecticide | Lice Insecticide
CVS Vitamin A &amp; D | CVS Vitamin A &amp; D
Desitin Creamy | Desitin Creamy
Citronella Oil | Citronella Oil
Tri-Previfem | Tri-Previfem
Antifungal | Antifungal
Cold and Flu | Cold and Flu
Boudreauxs Baby Butt Smooth | Boudreauxs Baby Butt Smooth
RA Ibuprofen Childrens | RA Ibuprofen Childrens
Mapap | Mapap
Carbidopa-Levodopa | Carbidopa-Levodopa
Hepatitis B Vac Recombinant | Hepatitis B Vac Recombinant
HPV Bivalent (16 &amp; 18) Vaccine | HPV Bivalent (16 &amp; 18) Vaccine
Influenza Vac Types A &amp; B PF | Influenza Vac Types A &amp; B PF
Tetanus-Diphth-Acell Pertussis | Tetanus-Diphth-Acell Pertussis
Varicella Virus Vaccine Live | Varicella Virus Vaccine Live
Neomy-Bacit-Polymyx-Pramoxine | Neomy-Bacit-Polymyx-Pramoxine
Lupron | Lupron
RhoGAM (Human) | RhoGAM (Human)
Dipyridamole | Dipyridamole
Valcyte | Valcyte
Diprolene | Diprolene
Zinc-Oxyde Plus | Zinc-Oxyde Plus
Polyethyl Glycol-Propyl Glycol | Polyethyl Glycol-Propyl Glycol
Enoxaparin Sodium | Enoxaparin Sodium
B-Complex | B-Complex
Bepreve | Bepreve
Dorzolamide HCl-Timolol Mal | Dorzolamide HCl-Timolol Mal
Monistat 7 Combination Pack | Monistat 7 Combination Pack
Pedia-Pop | Pedia-Pop
Neosporin AF | Neosporin AF
Iodosorb | Iodosorb
Digoxin | Digoxin
Cepacol Sore Throat Spray | Cepacol Sore Throat Spray
Diprolene AF | Diprolene AF
Micatin | Micatin
PediaCare Infant | PediaCare Infant
A + D Personal Care Wipes | A + D Personal Care Wipes
CVS Saline Nose Spray | CVS Saline Nose Spray
Hepatitis A Vaccine | Hepatitis A Vaccine
Baby Rectal Thermometer | Baby Rectal Thermometer
Acephen | Acephen
Omega-3-acid Ethyl Esters | Omega-3-acid Ethyl Esters
Ocean Nasal Moisturizer | Ocean Nasal Moisturizer
Estrogens Conjugated | Estrogens Conjugated
Enfamil LactoFree LIPIL | Enfamil LactoFree LIPIL
Gauze Pads &amp; Dressings | Gauze Pads &amp; Dressings
Nonoxynol-9 | Nonoxynol-9
Inderal LA | Inderal LA
Ear Wax Removal Aid | Ear Wax Removal Aid
Vicks Vaporizer | Vicks Vaporizer
Feosol Bifera | Feosol Bifera
A+D Cracked Skin Relief | A+D Cracked Skin Relief
Iodine Tincture | Iodine Tincture
Phillips Milk of Magnesia | Phillips Milk of Magnesia
Polyvinyl Alcohol-Povidone | Polyvinyl Alcohol-Povidone
Centrum Adults | Centrum Adults
SM Nasal Spray Saline | SM Nasal Spray Saline
Kids Vitamins | Kids Vitamins
Slow Release Iron | Slow Release Iron
Balmex Baby | Balmex Baby
Dunlap Instant Ice Pack | Dunlap Instant Ice Pack
Head &amp; Shoulders Dry 2 in 1 | Head &amp; Shoulders Dry 2 in 1
Multi Max | Multi Max
Desitin Clear | Desitin Clear
Enfamil ProSobee/Sensitive | Enfamil ProSobee/Sensitive
Pamprin Multi-Symptom | Pamprin Multi-Symptom
Clear Away | Clear Away
Vaporizing Chest Rub | Vaporizing Chest Rub
Cogentin | Cogentin
Theophylline | Theophylline
NovoLog PenFill | NovoLog PenFill
DiphenhydrAMINE Citrate | DiphenhydrAMINE Citrate
Pari Baby Conversion Kit | Pari Baby Conversion Kit
Wymzya Fe | Wymzya Fe
Coppertone Kids SPF30 | Coppertone Kids SPF30
Isomil Advance | Isomil Advance
Multi Vita-Bets/Fluoride | Multi Vita-Bets/Fluoride
Weight Loss Daily Multi | Weight Loss Daily Multi
Rehydralyte | Rehydralyte
Benadryl Allergy/Cold | Benadryl Allergy/Cold
Similac Sensitive | Similac Sensitive
Enfamil Gentlease | Enfamil Gentlease
Similac Advance | Similac Advance
Antihemophilic Factor | Antihemophilic Factor
Senokot S | Senokot S
Aspirin Adult Low Dose | Aspirin Adult Low Dose
Similasan Hay Fever Relief | Similasan Hay Fever Relief
CVS Clotrimazole | CVS Clotrimazole
Venlafaxine HCl ER | Venlafaxine HCl ER
Zicam Allergy Relief | Zicam Allergy Relief
Excedrin Extra Strength | Excedrin Extra Strength
Mag-Al Plus XS | Mag-Al Plus XS
Asacol HD | Asacol HD
Swimmers Ear Drops | Swimmers Ear Drops
CompMist Compressor Nebulizer | CompMist Compressor Nebulizer
Desonide Lot-Moisturizing Crea | Desonide Lot-Moisturizing Crea
Isomil DF | Isomil DF
Robitussin Cough/Allergy | Robitussin Cough/Allergy
SM Saline Solution | SM Saline Solution
Suction Tips | Suction Tips
Isomil/Iron | Isomil/Iron
Diphenoxylate-Atropine | Diphenoxylate-Atropine
Baby Vitamin | Baby Vitamin
Colic Drops | Colic Drops
Ocean for Kids | Ocean for Kids
Vitamin A | Vitamin A
Simply Saline | Simply Saline
Cortizone-10 | Cortizone-10
Glucose | Glucose
Pedvax HIB | Pedvax HIB
Pneumococcal 13-Val Conj Vacc | Pneumococcal 13-Val Conj Vacc
Micropore | Micropore
Menstrual Pain Relief | Menstrual Pain Relief
Enfalyte | Enfalyte
Kerlix Gauze Roll Small | Kerlix Gauze Roll Small
Laxative | Laxative
Asthma Rx | Asthma Rx
Tri-Vitamin | Tri-Vitamin
Little Remedies Poison Treat | Little Remedies Poison Treat
VoSoL HC | VoSoL HC
Eucerin Daily Protection/SPF30 | Eucerin Daily Protection/SPF30
Guards | Guards
Bepotastine Besilate | Bepotastine Besilate
Collyrium Eye Wash | Collyrium Eye Wash
CVS Eye Wash | CVS Eye Wash
Vantin | Vantin
Baby Oral Thermometer | Baby Oral Thermometer
Pari Soft Plastic Ped Mask | Pari Soft Plastic Ped Mask
Ayr Saline Nasal Neti Rinse | Ayr Saline Nasal Neti Rinse
Ora Relief | Ora Relief
Nipple Shields | Nipple Shields
ProSobee | ProSobee
Bee Pollen | Bee Pollen
Robitussin Cough/Cold D | Robitussin Cough/Cold D
Duo | Duo
Petrolatum-Zinc Oxide | Petrolatum-Zinc Oxide
Zinc 15 | Zinc 15
Omega 3-6-9 Fatty Acids | Omega 3-6-9 Fatty Acids
Betadine Surgical Scrub | Betadine Surgical Scrub
Diazoxide | Diazoxide
Diuril | Diuril
Levemir | Levemir
Novolin 70/30 PenFill | Novolin 70/30 PenFill
NovoLog Mix 70/30 Flexpen | NovoLog Mix 70/30 Flexpen
Hydrocell Adhesive Dressing | Hydrocell Adhesive Dressing
Phenyleph-CPM-DM-APAP | Phenyleph-CPM-DM-APAP
Pneumovax 23 | Pneumovax 23
Q-Tussin DM | Q-Tussin DM
Metronid-Tetracyc-Bis Subsal | Metronid-Tetracyc-Bis Subsal
Enfamil AR Spit-Up | Enfamil AR Spit-Up
Triple Antibiotic Plus | Triple Antibiotic Plus
Albuterol-Ipratropium | Albuterol-Ipratropium
Aug Betamethasone Dipropionate | Aug Betamethasone Dipropionate
Silver Nitrate Applicator | Silver Nitrate Applicator
FP Ibuprofen | FP Ibuprofen
Little Noses Saline Nasal Mist | Little Noses Saline Nasal Mist
PediaSure Shake/Fiber | PediaSure Shake/Fiber
Monistat 7 | Monistat 7
Monistat Soothing Care | Monistat Soothing Care
HCA Ibuprofen M | HCA Ibuprofen M
Garamycin | Garamycin
Timolol | Timolol
Kaz Vaporizer | Kaz Vaporizer
Baby Lotion | Baby Lotion
Estrogens, Conjugated | Estrogens, Conjugated
Panoxyl | Panoxyl
Pediatric Vitamins ACD-Iron | Pediatric Vitamins ACD-Iron
GNP Nasal Moisturizing | GNP Nasal Moisturizing
Q-PAP | Q-PAP
Similac Sensitive Fussiness | Similac Sensitive Fussiness
Zidovudine | Zidovudine
Armour Thyroid | Armour Thyroid
Nordette | Nordette
Hyoscyamine Sulfate | Hyoscyamine Sulfate
Enfamil ProSobee Soy | Enfamil ProSobee Soy
Guaiasorb DM | Guaiasorb DM
Triamcinolone in Absorbase | Triamcinolone in Absorbase
Sabril | Sabril
Asepto Bulb Syringes | Asepto Bulb Syringes
Lacri-Lube S.O.P. | Lacri-Lube S.O.P.
Timolol Maleate | Timolol Maleate
Digital Temple Thermometer | Digital Temple Thermometer
Nystop | Nystop
Omega DHA | Omega DHA
White Petrolatum | White Petrolatum
Eucerin Original Healing | Eucerin Original Healing
Antacid/Simethicone | Antacid/Simethicone
Antivert | Antivert
Echinacea | Echinacea
Pediarix | Pediarix
Rotarix | Rotarix
Vaseline Pure Ultra White | Vaseline Pure Ultra White
Tri-Vita | Tri-Vita
Vitamin Daily | Vitamin Daily
CVS Zinc Oxide | CVS Zinc Oxide
CitraNatal 90 DHA | CitraNatal 90 DHA
RSV Immune Globulin (Human) | RSV Immune Globulin (Human)
Gas-X Infant Drops | Gas-X Infant Drops
30 Second Digital Thermometer | 30 Second Digital Thermometer
Femcon Fe | Femcon Fe
Dapsone | Dapsone
Magnesium Oxide -Mg Supplement | Magnesium Oxide -Mg Supplement
Psoriasis Medicated | Psoriasis Medicated
AF-Ibuprofen | AF-Ibuprofen
AF-Pseudoephedrine HCl | AF-Pseudoephedrine HCl
Pedia-Lax Fiber Gummies | Pedia-Lax Fiber Gummies
Erythromycin Base Coated | Erythromycin Base Coated
Seroquel XR | Seroquel XR
Cold/Hot Patch | Cold/Hot Patch
Cool &amp; Heat Patch | Cool &amp; Heat Patch
Cool N Heat Patch Ex St | Cool N Heat Patch Ex St
Medicated | Medicated
Albertsons Ibuprofen | Albertsons Ibuprofen
Acne Pimple Medication | Acne Pimple Medication
Gauze Bandage 3" | Gauze Bandage 3"
Air Filter | Air Filter
Little Remedies Honey Cough | Little Remedies Honey Cough
Tums E-X 750 | Tums E-X 750
Acne Treatment | Acne Treatment
Pari Baby | Pari Baby
Abdominal Binder/Elastic 2XL | Abdominal Binder/Elastic 2XL
Norethindrone Acet-Ethinyl Est | Norethindrone Acet-Ethinyl Est
Heating Pad | Heating Pad
Tegaderm | Tegaderm
Alitretinoin | Alitretinoin
Minocin PAC | Minocin PAC
Eczema &amp; Psoriasis Spray | Eczema &amp; Psoriasis Spray
Ibuprofen IB | Ibuprofen IB
Bicitra | Bicitra
Hydrocortisone-Emollient | Hydrocortisone-Emollient
Antioxidant Vitamins | Antioxidant Vitamins
Tri-Linyah | Tri-Linyah
Pain Reliever | Pain Reliever
Neutrogena Body Clear Wash | Neutrogena Body Clear Wash
Icy Hot Medicated Spray | Icy Hot Medicated Spray
JointFlex | JointFlex
Johnsons Baby Cream | Johnsons Baby Cream
Vapor Inhaler | Vapor Inhaler
Tri-Vi-Flor | Tri-Vi-Flor
Gripe Water | Gripe Water
Post-OP Shoe/Soft Top Women | Post-OP Shoe/Soft Top Women
Lip Balm | Lip Balm
Testosterone | Testosterone
Selsun Blue Deep Cleansing | Selsun Blue Deep Cleansing
Alcohol Prep Pad | Alcohol Prep Pad
Similac/Iron | Similac/Iron
Balneol | Balneol
Sur-Fit Natura Little Ones | Sur-Fit Natura Little Ones
Sur-Fit Natura Stomahesive | Sur-Fit Natura Stomahesive
Implanon | Implanon
Dover Irrig Bulb Syringe | Dover Irrig Bulb Syringe
Prena1 | Prena1
Pari Baby Size 1/Pari LC Plus | Pari Baby Size 1/Pari LC Plus
Sinus Nasal Spray | Sinus Nasal Spray
Asepto Bulb Syr 1/2oz | Asepto Bulb Syr 1/2oz
Tri-Vi-Flor/Iron | Tri-Vi-Flor/Iron
Baby Oil | Baby Oil
Ped Multiple Vit-Minerals-Fl | Ped Multiple Vit-Minerals-Fl
Ped Multivit-Fl-Iron Biphasic | Ped Multivit-Fl-Iron Biphasic
Diphenhydramine-Phenylephrine | Diphenhydramine-Phenylephrine
Similac Lactose Free | Similac Lactose Free
Enfamil Soy ProSobee | Enfamil Soy ProSobee
Alcohol Prep Pads | Alcohol Prep Pads
Infant Care Products | Infant Care Products
Theratears | Theratears
Silver Nitrate-Pot Nitrate | Silver Nitrate-Pot Nitrate
Vitamin B1 | Vitamin B1
